Agni-P.	(PW) AGNIPURĀṆA in der Bibl. ind. 
Ait. Ār.	(PW) AITAREYĀRAṆYAKA in der Bibl. ind. In der Regel citirt nach Seite und Zeile (KERN und ROTH). 
Ait. Br.	(PW) AITAREYABRĀHMAṆA, Ausg. von HAUG. 
AK.	(PW) AMARAKOŚA, Ausg. von LOISELEUR DESLONGCHAMPS. 
Alaṃkārar.	(CSL) Alaṃkāraratnākara, Alaṃkārarahasya, or Alaṃkārarāghava
Alaṃkāras.	(CSL PW?) ALAṂKĀRAŚEKHARA, lith. Ausg. Benares 1923 (TH. AUFRECHT und R. PISCHEL).
Alaṃkāraś.	(PW) ALAṂKĀRAŚEKHARA, lith. Ausg. Benares 1923 (TH. AUFRECHT und R. PISCHEL).
Alaṃkārat.	(PW) ALAṂKĀRATILAKA, Hdschr. (AUFRECHT). 
Alaṃkārav.	(PW) ALAṂKĀRAVIMARŚINĪ von JAYARATHA, Deccan Coll. Hdschr. No. 230 (PISCHEL). 
Amaru	(SCH) Amaru(śatakam) ed. Simon und ed. Kāvyamālā.
Amit.	(SCH) Amit(agati), Subhāsitasamdoha ed. Hertel u. Schmidt, ZDMG 59. 61.
Ānandal.	(PW) ĀNANDALAHARĪ in HAEBELIN’s Anthologie. 
Anarghar.	(PW) ANARGHARĀGHAVA, Calcutta Śaka 1782 (AUFRECHT). 
Anarghar. S.	?(PW) ANARGHARĀGHAVA, Calcutta Śaka 1782 (AUFRECHT). 
Anarghyar.	[unknown] (1)
Anir.	[unknown] (1)
Antyeṣṭik.	(PW) [unknown literary source]
Anukr.	[unknown]
Āpast.	(PW) ĀPASTAMBA’S DHARMASŪTRA, Ausg. von BÜHLER. 
Āpast. Gṛhy.	(CSL) Āpastamba’s Gṛhyasūtra
Āpast. Gṛhyas.	(CSL) Āpastamba’s Gṛhyasūtra
Āpast. Śr.	(PW) ĀPASTAMBA’S ŚRAUTASŪTRA, Hdschr. (GARME und ROTH). 
Ārṣ. Br.	(PW) ĀRṢEYABRĀHMAṆA, Ausg. von BURNELL. 
Āśv. Gṛhy.	(PW) ĀŚVALĀYANA’S GṚHYASŪTRA; Ausg. von STENZLER. 
Āśv. Śr.	(PW) ĀŚVALĀYANA’s ŚRAUTASŪTRA in der Bibl. ind. 
Aśvav.	(PW) [unknown literary source]
Ath. Anukr.	(CSL) anukramaRikA (index) of Atharvaveda.
Ath. Paddh.	(CSL PW) Paddhati (guide book) for Atharvaveda
Ath. Paddhati	(CSL PW) Paddhati (guide book) for Atharvaveda
Ath. Par.	[CSL PW] (PW) PARIŚIṢṬA zum AV. , Hdschr. (ROTH). 
Ath. Pariś.	[CSL PW] (PW) PARIŚIṢṬA zum AV. , Hdschr. (ROTH). 
AV.	(PW) ATHARVAVEDA, Ausg. von ROTH und WHITNEY (ROTH). 
AV. Anukr.	(PW CSL) anukramaRikA (index) of Atharvaveda.
AV. Paipp.	(PW) AV. der PAIPPALĀDA-Schule, Hdschr. (ROTH). 
AV. Pariś.	(PW) PARIŚIṢṬA zum AV. , Hdschr. (ROTH). 
AV. Prāt.	(CSL PW) Prātiśākhya for Atharveda (a treatise on euphonic combination and pronunciation of letters)
Bādar.	(PW) BĀDARĀYAṆA’S BRAHMASŪTRA in der Bibl. ind. 
Bālar.	(PW) BĀLARĀMĀYAṆA, Benares 1869 (KERN). 
Baudh.	(PW) BAUDHĀYANA, nach Citaten in andern Werken. 
Baudh. Gṛhy.	(CSL) Gṛhyasūtras of Baudhāyana 
Baudh. Gṛhy. Pariś.	(PW CSL) Páriśiṣṭa (supplement) to Gṛhyasūtras of Baudhāyana 
Benf. Chr.	(PW) BENFEY’S Chrestomathie. 
Bhadrab.	(PW) BHADRABĀHUCARITRA, herausgegeben von H. Y. JACOBI in Z. d. d. m. G. 38, 19. fgg. (JACOBI). 
Bhag.	(PW) BHAGAVADGITĀ, Ausg. von SCHLEGEL. 
Bhāg. P.	(PW) BHĀGAVATAPURĀṆA. Die 9 ersten Skandha nach BURNOUF’s. Ausgabe, wenn nicht ausdrücklich. ed. Bomb. hinzugefügt wird; die letzten Skandha nach der ed. Bomb. In Klammern eingeschlossene Zahlen verweisen auf ed. Bomb. 
Bhām. V.	(PW) BHĀMINĪVILĀSA, Ausg. von ABELBERGAIGNER(CAPELLER. ) 
Bhānudatta’s Alaṃkāratilaka	(SCH) Bhānudatta’s Alaṃkāratilakam, Abschrift eines Ms. ans Islampurkar’s Besitz. Vgl. Festschrift Jacobi.
Bhār. Nāṭyaś.	(CSL PW) BHĀRATĪYANĀṬYAŚĀSTRA am Schluss von DAŚAR. in der Bibl. ind. 
Bhāradvājagṛhy.	(CSL) Bhāradvāja Gṛhyasūtra
Bhārat.	[PW CSL] BHĀRATĪYANĀṬYAŚĀSTRA am Schluss von DAŚAR. in der Bibl. ind. 
Bhārata, Nāṭyaś.	[PW CSL] BHĀRATĪYANĀṬYAŚĀSTRA am Schluss von DAŚAR. in der Bibl. ind. 
Bhāratīyanāṭyaś.	[PW CSL] BHĀRATĪYANĀṬYAŚĀSTRA am Schluss von DAŚAR. in der Bibl. ind. 
Bhāṣāp.	(PW) BHĀṢĀPARICCHEDA in der Bibl. ind. 
Bhaṭṭ.	(PW) BHAṬṬIKĀVYA, Calcutta 1828. 
Bhāvapr.	(PW) BHĀVAPRAKĀŚA, Calcutta 1875 und Hdschr. (ROTH). 
Bhāvat.	[CSL?] Bhāvátaraṃgiṇī
Bhaviṣyap.	(PW) BHAVIṢYAPURĀṆA Hdschr. (AUFRECHT). 
Bhikṣāṭanakāvya	[CSL MW] Name of a poem
Bhoja-Pr.	(PW) BHOJAPRABANDHA, Benares 1925(KERN). 
Bibl. ind.	(PW) Bibliotheca indica. 
Bibl. Ind.	(PW) Bibliotheca indica. 
Bodhicaryāv.	[CSL?] Name of work
Bodhicaryāvatāra	[CSL?] Name of work
Boll.	(CSL) Friedrich Bollensen (1809-1896). German Indologist in Russia.
Brahma-P. Uttarakh.	(CSL) uttarakhaṇḍa (concluding book) of Brahmapurāṇa
Brāhmaṇādhy.	[unknown]
Brahmap.	(CSL) Brahmapurāṇa
Brahmav. P.	(CSL) BRAHMAVAIVARTAPURĀṆA
Brahmavaiv.	(CSL) BRAHMAVAIVARTAPURĀṆA
Brahmavaiv. P.	(PW) BRAHMAVAIVARTAPURĀṆA. 
Bṛh. Ār. Up.	(PW) BṚHADĀRAṆYAKOPANIṢAD in der Bibl. ind. 
Bṛh. Ār. Up. S.	[CSL ?] BṚHADĀRAṆYAKOPANIṢAD S.?
Bṛhanm.	(PW) BṚHANMANU, nach Citaten in verschiedenen juristischen Büchern(JOLLY). 
Bṛhasp.	(PW) BṚHASPATI, nach Citaten in verschiedenen jurischen Büchern (JOLLY). 
Bṛhatkathām.	[CSL MW] Name of a collection of tales ascribed to Kṣemêndra 
Bṛhatkathāmañjarī	[CSL MW] Name of a collection of tales ascribed to Kṣemêndra 
BSB.	[unknown]
Bühler, Rep.	(PW) Detailed Report of a Tour in search of Sanskrit Mss. made. in Kāsmir, Rajputana, and Central India. By G. BÜHLER, Bombay 1877. 
Caṇḍak.	(PW) KṢEMĪŚVARA’S CAṆḌAKAUŚIKA (PISCHEL). 
Caṇḍīś.	(CSL) Caṇḍīśapurāṇa, another name of Śivapurāṇa
Caraka	(SCH) Caraka (ed. Debendra Nath Sen und Upendra Nath Sen, soweit es sich um meine eigenen Angaben handelt).
Caurap. (A.)	(CSL PW) Caurapañcāśikā, a poem by Bilhaṇa
Chānd. Up.	(PW) CHĀNDOGYOPANIṢAD in der Bibl. ind. 
Chāndogyap.	[unknown]
Chr.	(PW) BÖHTLINGK’S Sanskrit-Chresthomathie, 2te Aufl. 
Colebr. Alg.	(PW) COLEBROOKE, Algebra with Arithmetic and Mensuration u. s. w. London 1817. 
Colebr. Misc. Ess.	(PW) Miscellaneous Essays by H. T. COLEBROOKE. London. 1837. 
Damayantīk.	(CSL PW) Damayantīkāvya (Name of a poem) or &#13;&#10; Damayantīkathā, N. of Nalacampū (Name of a poem)
Dārila	(CSL PW) Name of a commentator on Kauśika’s sūtra on Atharvaveda
Darpad.	(PW) DARPADALANA von KṢEMENDRA, Hdschr. (AUFRECHT). 
Daśa K.	(CSL) Daśakarmapaddhatim name of work on the 10 ceremonies prescribed to the 3 twice-born classes
Daśak.	(PW) DAŚAKUMĀRA, Ausg. von BÜHLER (CAPELLER). 
Daśak. Pūrvap.	[unknown]
Daśar.	(PW) DAŚARŪPA in der Bibl. ind. 
Daśāv.	(SCH) Daśāv(atāracaritam) nach J. J. Meyer’s Angaben in seiner Übersetzung des Kuṭṭanīmatam.
Dattakaś.	(PW) DATTAKAŚIROMAṆI, Calcutta 1867 (JOLLY). 
Dattakatilaka	[unknown]
Dāy.	(PW) DĀYABHĀGA, Calcutta 1829. 
Deśīn.	(PW) HEMACANDRA’S DEŚĪNĀMĀLĀ, Hdschr. (PISCHEL). 
Devībhāg.	(CSL) Devībhāgavatapurāṇa, name of work; or Devībhāgavatasthiti, name of work.
Dharm.	(CSL) Dharmaśarmābhyudaya, name of work
Dharmaś.	(CSL) Dharmaśarmābhyudaya, name of work
Dharmaśarm.	(CSL) Dharmaśarmābhyudaya, name of work
Dharmaśarmābhy.	(CSL) Dharmaśarmābhyudaya, name of work
Dhātup.	(PW) DHĀTUPĀṬHA, Ausg. von WESTERGAARD. 
Dhātupārāyaṇa	(CSL) name of work on verbal roots
Dhvanyāloka	(CSL) name of work
Dināl.	[unknown]
Dināl.-Śuk.	[unknown]
Divyāv.	(CSL PW) DIVYĀVADĀNA, Hdschr. (SCHIEFNER). 
Divyāvad.	(PW) DIVYĀVADĀNA, Hdschr. (SCHIEFNER). 
Dravyaś.	(CSL) Dravyaśuddhi, name of work; or &#13;&#10; Dravyaśodhanavidhāna, name of work.
Eggeling, Cat.	[unknown]
Eggeling, Catal.	[unknown]
Gal.	(PW) GALANOS’s Wörterbuch, Abschrift von WEBER;vgl. Monatsbericht der Kön. Pr. Akad. der Wissensch. 1876, S. 801. fgg. (CAPELLER). 
Gaṇap.	[unknown]
Gaṇar.	(PW) GAṆARATNAMAHODADHI, nach der im Druck befindlichen Ausg. von EGGELING. Nur ein paar Mal gelegentlich citirt. 
Garbhop.	(PW) GARBHOPANIṢAD in Bibl. ind. (GELDNER und ROTH). 
Gaut.	(PW) GAUTAMA’S DHARMAŚĀSTRA, Ausg. von STENZLER. 
Ghāṭe	[unknown]
Gīt.	(PW) GĪTAGOVINDA, Ausg. von LASSEN. 
Gītag.	(CSL PW) GĪTAGOVINDA, Ausg. von LASSEN. 
Gobh.	(PW) GOBHILA’S GṚHYASŪTRA in der Bibl. ind. (ROTH). 
Gobh. Śrāddh.	(CSL PW) GOBHILA’S ŚRĀDDHAKALPA in der Bibl. ind. 
Gobh. Śrāddhak.	(PW) GOBHILA’S ŚRĀDDHAKALPA in der Bibl. ind. 
Gop.	[unknown]
Gop. Br.	(PW) GOPATHABRĀHMAṆA in der Bibl. ind. (ROTH). 
Gopāl.	(SCH) Gopāl(akelicandrikā) ed. W. Caland, Amsterdam 1917. Wörterverzeichnis S. 151-152.
Govardh.	(PW) Govardhana’s SAPTAŚATĪ (WEBER) . 
Gṛhyās.	(PW) GṚHYĀSAṂGRAHA in der Bibl. ind. 
Gṛhyas.	[unknown]
H	(CSL PW) HEMACANDRA’S ABHIDHĀNACINTĀMAṆI, Ausg. von BÖHTLINGK und RIEU.
H. an.	(PW) HEMACANDRA’S ANEKĀRTHASAṂGRAHA. 
H. Deś.	[unknown]
Haeb. Chr.	[unknown]
Halāy.	(PW) HALĀYUDHA’S Wörterbuch, Ausg. von AUFRECHT. 
Har.	[unknown]
Hār.	(PW) HĀRĀVALI. 
Hārītasaṃh.	(CSL) Hārītasaṃhitā, name of work
Hariv.	(PW) HARIVAṂŚA. Mit einer Zahi die ältere Calc. Ausg. gemeint, drei Zahlen die neuere lithographirte. 
Harṣ.	(CSL PW) HARṢACARITA, Calcutta 1876 (KERN).
Harṣac.	(PW) HARṢACARITA, Calcutta 1876 (KERN). 
Hem. Abhidhānac.	(CSL) Abhidhānacintāmaṇi m. ‘the jewel that gives every word’, name of Hemacandra’s vocabulary of synonyms. 
Hem. An.	[unknown]
Hem. Anek.	[unknown]
Hem. Deś.	[unknown]
Hem. Par.	(PW) HEMACANDRA’S PARIŚIṢṬAPARVAN, Hdschr. (JACOBI). 
Hem. Pr. Gr.	(PW) [unknown literary source]
Hem. Prākr.	[unknown]
Hem. Uṇ.	[unknown]
Hem. Uṇādis.	[unknown]
Hem. Yog.	(PW) HEMACANDRA’S YOGAŚĀSTRA in Z. d. d. m. G. 28. Aus einem hdschr. Comm. hat WINISCH manche Berichtigung und Erklärung mir bereitwilligst zukommen lassen. 
Hem. Yogaś.	(CSL PW) HEMACANDRA’S YOGAŚĀSTRA in Z. d. d. m. G. 28. Aus einem hdschr. Comm. hat WINISCH manche Berichtigung und Erklärung mir bereitwilligst zukommen lassen. 
Hem. Yogay.	[unknown]
Hiouen-Thsang	(PWG)  Histoire de la vie de HIOUEN-THSANG et de ses voya- ges dans l’Inde, traduite du Chinois par STANISLAS YULIEN. Paris 1853.
Hiraṇy. Śr.	[unknown]
Hit.	(PW) HITOPADEŚA, Ausg. von SCHLEGEL und LASSEN. 
Ind. Antiq.	(PW) Indian Antiquary (ROTH). 
Ind. Erb.	[unknown]
Ind. St.	(PW) Indische Studien von WEBER. 
Ind. Str.	[unknown]
Ind. Stud.	(CSL PW) Indische Studien von WEBER. 
Ind. Studien	(CSL PW) Indische Studien von WEBER. 
Indian Antiquary	(CSL PW) Indian Antiquary (ROTH). 
J. J. Meyer	[unknown]
Jaim.	(PW) JAIMINI’S Mimāṃsādarśana in der Bibl. ind. 
JAOS, Proc.	(CSL) Journal of the American Oriental Society, Proceedings
JAOS.	(CSL) Journal of the American Oriental Society
JAOS. Proc.	(CSL) Journal of the American Oriental Society, Proceedings
JAS. Beng.	(CSL) Journal of the Asiatic Society of Bengal
Jātakam.	(PW) JĀTAKAMĀLĀ, Hdschr. (H. KERN). 
JRAS	(CSL PW) Journal of the Royal Asiatic Society (KERN)
JRAS. Beng.	[unknown]
Kād.	(PW) KĀDAMBARĪ, Calcutta Saṃvat 1919 (KERN). 
Kālac.	(PW) KĀLACAKRA, Hdschr. (SCHIEFNER). 
Kalāv.	(SCH) Kalāv(ilasa) ed. Kāvyamālā, Part I, p. 34 ff.
Kalāvil.	[unknown]
Kalpas.	(PW) KALPASŪTRA, herausg. von H. JACOBI (JACOBI und KERN). 
Kām. Nītis.	(PW) KĀMANDAKĪYANĪTISĀRA in der Bibl. ind. 
Kāmas.	(CSL) Kāmasūtra, name of a treatise on sexual love by Vātsyāyana
Kaṃs.	(SCH) Kaṃs(avadha) ed. Nirṇayasāgara-Press, Bombay 1888. (Kāvyamālā Nr. 6.)
Kandarp.	(CSL) Kandarpacūḍāmaṇi, name of work
Kap.	(PW) KAPILA’S SĀṂKHYAPRAVACANA. Einen vollständigen Index hat WINDISCH ZU Verfügung gestellt. 
Kap. S.	(PW) KAPIṢṬHALAKAṬHASAṂHITA, Hdschr. (v. SCHRÖDER). 
Kār.	(CSL PW) KĀRAṆḌAVYŪHA, Calcutta 1873(KERN). 
Kāraṇḍ.	(PW) KĀRAṆḌAVYŪHA, Calcutta 1873(KERN). 
Kāraṇḍavy.	(CSL PW) KĀRAṆḌAVYŪHA, Calcutta 1873(KERN). 
Karmapr.	(PW) KARMAPRADĪPA (STENZLER). Steht unter dem falschen Titel KĀTYĀYANASMṚTI im DHARMAŚĀSTRASAṂGRAHA, Vol. I, S 603-644. 
Karṇas.	(SCH) Karṇas(undarī) ed. Kāvyamālā Nr. 7, Bombay 1888.
Kāś.	(PW) KĀŚIKĀ VṚTTI in der Zeitschrift The PANDIT VII. fgg. 
Kāśīkh.	(PW) KĀŚĪKHAṆḌA, HDSCHR. (AUFRECHT). 
Kaśm. Ś.	[unknown]
Kaśm. Śiv.	[unknown]
Kāt.	(PW) KĀTANTRA, heraugsgegeben von EGGELING. 
Kāṭh.	(PW) KĀṬHAKA (WEBER). 
Kathāk.	(SCH) Kathāk(autukam) meine Ausgabe, Kiel 1898.
Kathākaut.	(CSL SCH) Kathāk(autukam) meine Ausgabe, Kiel 1898.
Kathākautukam	(CSL SCH) Kathāk(autukam) meine Ausgabe, Kiel 1898.
Kathās.	(PW) KATHĀSARITSĀGARA, Ausg. von BROCKHAUS. 
Kaṭhop.	(PW) KAṬHOP(ANIṢAD) in der Bibl. ind. 
Kāty.	(PW) KĀTYĀYANA’S PARIBH (ĀṢĀS) IN ’Zwölf Hymnen des Rigveda, herausgegeben von ERNST WIDISCH’S. 169. fgg. 
Kāty. Śr.	(PW) KĀTYĀYANA’S ŚRAUTASŪTRA, nach WEBER’S Index. 
Kāty. Śrāddhak.	[unknown]
Kauś.	(PW) KAUŚIKA’S SŪTRA zum AV. , Hdschr. (ROTH und WEBER). 
Kaus.	[unknown]
Kauṣ. Up.	(PW) KAUṢITAKIBRĀHMAṆOPANIṢAD in der Bibl. ind. 
Kauśikasūtra	(PW CSL) KAUŚIKA’S SŪTRA zum AV. , Hdschr. (ROTH und WEBER).
Kaut.	(SCH) Kaut(ilīyam Arthaśāstram), Jolly’s Liste IF 31, 204 ff. M = ed. 1909; A = Münchener Ms Nr. 334, B = Nr. 335.
Kauṭ.	(SCH) Kauṭ(ilīyam Arthaśāstram ed. Mysore 1909) an der Hand der Übersetzung von J. J. Meyer. Benutzt bis S. 173 des Sanskrittextes.
Kautukar.	(PW) KAUTUKARATNĀKARA, Hdschr. (CAPELLER). 
Kautukas.	(CSL) Kautukasarvasva, name of a comedy.
Kāvyād.	(CSL) Kāvyādarśa, name of work on poetics by Daṇḍin
Kāvyāl.	(PW) KĀVYĀLOKALOCANA, Hdschr. (AUFRECHT). 
Kāvyamālā	[unknown]
Kāvyapr.	(PW) KĀVYAPRAKĀŚA, Calcutta 1866. Nach Ullāsa und Sūtra citirt, wenn nicht S. (Seite) und Z. (Zeile) hinzungefügt werden. 
Kenop.	(PW) KENOPANIṢAD in der Bibl. ind. 
Khaṇḍapr.	(CSL) Khaṇḍapraśasti, name of a poem attributed to Hanūmat
Kir.	(PW) KIRĀTĀRJUNIYA, Calcutta 1814. 
Kirāt.	(CSL PW) KIRĀTĀRJUNIYA, Calcutta 1814. 
Kṣem.	(PW) KṢEMENDRA’S KAVIKAṆṬĀBHARAṆA, herausgegeben von Y. SCHÖNBERG in den Sitzungsberichten der Phil-hist. Klasse der Kais. Ak. d. Ww. in Wien, Bd. 106 (C. CAPELLER). 
Kṣurikop.	(PW) KṢURIKOPANIṢAD in der Bibl. ind. 
Kuhn’s Z.	(PW) Zeitschrift für vergleichende Sprachforschung anf dem Gebiete der indogermanischen Sprachen. 
Kull.	(PW) KULLŪKA, Commentator des MANU. 
Kumāras.	(PW) KUMĀRASAṂBHAVA, Ausg. von STENZLER. 
Kusum.	(PW) KUSUMĀÑJALI, Ausg. von COWELL. 
Kuṭṭ.	(SCH) Kuṭṭ(anīmatam) ed. Kāvyamālā. (Nach J. J. Meyer.)
Kuṭṭanīm.	(CSL) Kuṭṭ(anīmatam) ed. Kāvyamālā. (Nach J. J. Meyer.)
Kuval.	(SCH) Kuval(ayānandakārikā) ed. Bombay, NSP, śak. 1808.
LA.	(PW) LASSEN’S Anthologie 3te Ausg. 
Laghuk.	(PW) LAGHUKAUMUDĪ, Ausg. von BALLANTYNE, Benares 1876(CAPELLER). 
Lakṣmaṇasūri	(CSL) Gītagovindaṭīkā Śrutirañjinī
Lalit.	(PW) LALITAVISTARAPURĀṆA in der Bibl. ind. (KERN). 
Laṭ.	(SCH) Laṭ(akamelakam) ed. Kāvyamālā Nr. 20.
Lāṭy.	(PW) LĀṬYĀYANA’S ŚRAUTASŪTRA in der Bibl. ind. 
Leumann.	(CSL) Ernst Leumann (1859-1931), Swiss linguist
Līlāv.	(PW) BHĀSKARA’S LĪLĀVATĪ, Calcutta 1846 (KERN). 
Liṅg.	[unknown]
Lot. de la b. l.	(PW) BURNOUF, Lotus de la bonne loi. 
M.	(PW) MĀNAVADHARMAŚĀSTRA. 
M. Müller, Ren.	(PW) The Renaissance of Sanskrit Literature in M. MüLLER’S India what can it teach us? S. 281. fgg. Auch die vorangehenden Abschnitte werden so citirt. 
Madanav.	(PW) MADANAPĀLA’S MADANAVINODA, Benares 1869 und Hdschr. (ROTH). 
Mahābh.	(PW) MAHĀBHĀṢYA, lith. in Benares. 
Mahābh. (K.)	(PW) KIELHORN’S Ausg. des MAHĀBHĀṢYA. 
Mahābhy.	[unknown]
Mahād.	[unknown]
Mahāparin.	(CSL) Mahāparinirvāṇa, name of a Buddhist Sūtra. 
Mahāv.	(CSL SCH) Mahāvīr(acaritam) ed. Aiyar, Bombay 1901 und ed. Lakṣmaṇasūri, new edition, Madras 1904.
Mahāvīr.	(SCH) Mahāvīr(acaritam) ed. Aiyar, Bombay 1901 und ed. Lakṣmaṇasūri, new edition, Madras 1904.
Mahavīr.	(CSL) mahavīrya, name of a teacher
Mahāvīr. ed. Aiyar	(SCH) Mahāvīr(acaritam) ed. Aiyar, Bombay 1901 und ed. Lakṣmaṇasūri, new edition, Madras 1904.
Mahāvīrac.	(PW) MAHĀVĪRACARITA, Ausg. von TRITHEN. 
Mahāvīrac. ed. Aiyar	(SCH) Mahāvīr(acaritam) ed. Aiyar, Bombay 1901 und ed. Lakṣmaṇasūri, new edition, Madras 1904.
Mahāvy.	(CSL) Mahāvyutpatti, name of a Sanskṛt-Tibetan lexicon.
Mahāvyut.	(CSL) Mahāvyutpatti, name of a Sanskṛt-Tibetan lexicon.
Mahīdh.	(PW) MAHĪDHARA, Commentator der VS. 
Maitr.	(CSL PW) MAITRĀYAṆI SAṂHITĀ, zur Herausgabe vorbereitet von L. SCHRÖDER. Da die accentuirten Hdschr. nicht gleich zu Anfang zur Hand waren, konnten einige Accente erst in den Nachträgen angegeben werden (SCHRÖDER). 
Maitr. S.	(PW) MAITRĀYAṆI SAṂHITĀ, zur Herausgabe vorbereitet von L. SCHRÖDER. Da die accentuirten Hdschr. nicht gleich zu Anfang zur Hand waren, konnten einige Accente erst in den Nachträgen angegeben werden (SCHRÖDER). 
Maitryup.	(PW) MAITRYUPANIṢAD in der Bibl. ind. Die Accente, die wegen ihrer Fehlerhaftigkeit oft weggelassen oder durch (!) als verdächtig bezeichnet wurden, hat SCHRÖDER einer Hdschr. entnommen. 
Mālatīm.	(PW) MĀLATĪMĀDHAVA, nach zwei Ausgaben, Calcutta 1830 und Bombay 1876. 
Mālatīm. (B. S. S.)	(CSL) MĀLATĪMĀDHAVA
Mālav.	(PW) MĀLAVIKĀGNIMITRA, Ausg. von TULLIBERG. 
Mālavik.	(CSL) MĀLAVIKĀGNIMITRA, Ausg. von TULLIBERG. 
Mallin.	(PWG) MALLINĀTHA, name of a poet and commentator.
Mān. Gṛhy.	(PW) MĀNAVAGṚHYASŪTRA, nach einer Hdschr. in der Universitätsbibliothek zu Bombay (SCHRÖDER). 
Mān. Śr.	(PW) MĀNAVAŚRAUTASŪTRA, Hdschr. (v. SCHRÖDER). 
Māṇḍ. Up.	(PW) MĀṆḌŪKYOPANIṢAD in der BIbl. ind. 
Manm.	(CSL SCH)  Manmatk(onmathana), meine Ausgabe ZDMG 63.
Manmatk.	(SCH) Manmatk(onmathana), meine Ausgabe ZDMG 63.
Mārk. P.	(PW) MĀRKAṆḌEYAPURĀṆA in der Bibl. ind. 
Mat. med.	(PW) The Materia medica of the Hindus compiled from Sankr. medical works by UDOY CHAND DUTT Civil Medicinal officer. With a Glossary of Indian Plants by GE. KING. Superint. R. Bot. Garden Calc. and the author. Calcutta 1877. 
Matsya-P.	(PW) MATSYAPURĀṆA, Poona-Ausg. (AUFRECHT). 
Matsyap.	(PW) MATSYAPURĀṆA, Poona-Ausg. (AUFRECHT). 
MBh.	(PW) MAHĀBHĀRATA, citirt nach Parvan, Adhyāya und Śloka der Bomb. Ausg. Die ältere Calcuttaer Ausg. mit zwei Zahlen wird nur dann angeführt, wenn sie eine abweichende Lesart bietet. 
MBh. ed. Vardh.	(PW) MBH. ed. Vardh. ist die auf Kosten des Fürsten von Vardhamāna (Burdwan) gedruckte Ausg. des MAHĀBHĀRATA. Sie enthält nur die 12 ersten Parvan. 
Med.	(PW) MEDINIKOŚA. 
Med. k.	(PW CSL) MEDINIKOŚA k.?
Medhāt.	(PW) MEDHĀTITHI, ein Scholiast des MANU (JOLLY). 
Megh.	(PW) MEGHADŪTA, Ausg. von STENZLER. 
Mgs.	(SCH)  Mgs. = Mānavagṛhyasūtra ed. Knauer.
Mon. d. B. A.	(PW) Monatsberichte der Königlich Preussichen Akademie der Wissenschaften in Berlin. 
Monatsb. d. B. A.	(CSL PW) Monatsberichte der Königlich Preussichen Akademie der Wissenschaften in Berlin. 
Mṛcch.	(PW) MṚCCHAKAṬIKA, Ausg. von STENZLER. Comm. zu MṚCCH. sind die Auszüge in den Anmerkungen zu meiner Uebersetzung dieses Schauspiels. 
Mudrār.	(PW) MUDRĀRĀKṢASA, nach zwei Ausgaben, Calcutta 1831 und 1926 (CAPELLER). 
Muk.	(SCH) Muk(undānandabhāṇa) ed. Kāvyamālā Nr. 16.
Muṇḍ. Up.	(CSL) Muṇḍakopaniṣad, name of an Upaniṣad of the Atharvaveda 
Nāgān.	(PW) NĀGĀNANDA nach zwei Calcuttaer Ausgaben (CAPELLER) 
Naiṣ.	(PW) NAIṢADHACARITA. 
Nandap.	[unknown]
Nār.	(PW) NĀRADA’S DHARMAŚĀSTRA (JOLLY). 
Nārada (a.)	(PW) bezeichnet die ausführlichere Recension NĀRADA’S (JOLLY). 
Navasāhas.	(CSL) Navasāhasāṅkacarita, name of a poem by Śrīharṣa
Nigh.	(PW) YĀSKA’S NIRUKTA sammt den NIGHAṆṬAVAS, herausgegeben und erläutert von RUDOLPH ROTH. 
Nigh. Pr.	(PW) NIGHAṆṬUPRAKĀŚA (ROTH). 
Nīlak.	(PW) NĪLAKAṆṬHA, Commentator des MBH. 
Nir.	(PW) NIRUKTA, Ausg. von ROTH (ROTH). 
Nyāyak.	(CSL) Nyāyakaṇikā, name of a work
Nyāyak. Sāṃkhapr.	[unknown]
Nyāyam.	(PW) JAIMINIYANYĀYAMĀLĀVISTARA, Ausg. von GOLDSTÜCKER UND Cowell (KERN). 
Opp. Cat.	(PW) List of Sanskrit Manuscripts in Private libraries of southern India. Compiled, arranged and indexed by GUSTAV OPPERT. 
P.	(PW) PĀṆINI. 
Padap.	[unknown]
Pādāravindaś.	(CSL) Name of a poem
Pādāravindaśat.	(CSL) Name of a poem
Pādāravindaśataka	(CSL) Name of a poem
Paddh.	(PW) PADDHATI zu MĀN (AVA) GṚHY (ASŪTRA), Hdschr. (v. BRADKE). 
Padyac.	(SCH) Padyac(ūḍāmani) ed. Madras 1921.
Pañc.	[unknown]
Pañcad.	(PW) PAÑCADAṆḌACCHATTRABANDHA, herausg. von WEBER. 
Pañcadaṇḍacch.	(CSL PW) PAÑCADAṆḌACCHATTRABANDHA, herausg. von WEBER. 
Pañcar.	(PW) NĀRADA’S PAÑCARĀTRA in der Bibl. ind. 
Pañcat.	(PW)  ohne nähere Angabe PAÑCATANTRA, vollständige Ausg. von KOSEGARTEN. Mit Beifügung von ed. Bomb. --die Ausg. von BÜHLER und KIELHORN. 
Pār. Gṛhy.	(PW) PĀRASKARA’S GṚHYASŪTRA, Ausg. von STENZLER. 
Par. Sār.	(SCH) Par. Sār. = The Paramārtha Sāra (The Kashmir Series of Texts and Studies edited by J. C. Chatterji, Srinagar 1911 ff., Vol. VII).
Par. Tr.	(SCH) Par. Tr. = The Parā Trimsika (Vol. XXI in voriger Serie).
Parāś.	(PW) PARĀŚARA’S DHARMAŚĀSTRA (STENZLER). 
Parāśara	(CSL PW) Name of several authors
Parāśarasaṃhitā	(CSL) Name of a work
Paribh.	(PW) PARIBHĀṢĀ in PARIBHĀṢENDUŚEKHARA, Ausg. von KIELHORN. 
Pārijātam.	(SCH) Pārijātam(añjarī) ed. Hultzsch, Leipzig 1907.
Pārśvan.	(PW) PĀRŚVANĀTHAKĀVYA, Hdschr. (AUFRECHT). 
Pārv.	(CSL SCH) Pārvat(īpariṇayanātakam), meine Ausgabe (AKM XIII, 4; Leipzig 1917).
Pārvat.	(SCH) Pārvat(īpariṇayanātakam), meine Ausgabe (AKM XIII, 4; Leipzig 1917).
Pat.	(CSL PW) Patañjali 
Pischel, BB.	[unknown]
Pischel, de Gr. pr.	(PW) PISCHEL, de Grammaticis prācriticis. Vratislaviae 1874. 
Pischel, Ved. St.	(CSL) Richard Pischel, Vedische Studien (1889-1901)
Pischel, Ved. Stud.	(CSL) Richard Pischel, Vedische Studien (1889-1901)
Pischel, Ved. Studien	(CSL) Richard Pischel, Vedische Studien (1889-1901)
Pr. P.	(PW) PRACAṆḌAPĀṆḌAVA, EIN SCHAUSPIEL. HDSCHR. (CAPELLER). 
Prab.	(PW) PRABODHACANDRODAYA, Ausg. von BROCKHAUS. 
Prabandh.	(SCH) Prabandh(acintāmani) ed. Dīnānātha, Bombay 1888. "Tawney" bezeichnet seine englische Übersetzung, Calcntta 1901.
Prasannar.	(PW) JAYADEVA’S PRASANNARĀGHAVA (KERN). 
Pratāpar.	(PW) PRATĀPARUDRIYA. 
Pratijñās.	(PW) PRATIJÑĀS(ŪTRA) berausg. von A. WEBER. 
Praty. Hṛd.	(SCH) Praty. Hṛd. = Pratyabhijñā Hṛdaya (Vol. III der Kashmir Series).
Prāyaścittav.	(CSL PW) PRĀYAŚCITTA zum AV. , Hdschr. (ROTH). 
Priy.	(PW) PRIYADARŚIKĀ, Calcutta 18?? (CAPELLER). 
Priyad.	(CSL PW) PRIYADARŚIKĀ, Calcutta 18?? (CAPELLER). 
Proc. A. O. S.	(CSL) Proceedings of the American Oriental Society.
Proc. of the As. Soc. of Bengal	(CSL) Proceedings of the Asiatic Society of Bengal
Pūrṇabh.	(SCH) Pūrṇabh(adra), nach Hertel’s Liste in dessen Ausgabe.
R.	(PW) RĀMĀYAṆA. Das 1ste und 2te Kāṇḍa nach der Ausg. von SCHLEGEL, das 3--6te nach der von GORRESIO, das 7te nach der Bomb. Ausg., wenn nicht ausdrücklich eine andere Ausgabe genannt ist. Eine eingeklammerte Zahl bezieht ist sich auf ed. Bomb. 
R. ed. Bomb.	(CSL PW) RĀMĀYAṆA, Bombay edition
R. Gorr.	(PW)  RĀMĀYAṆA, translation by Gaspare Gorresio. [Cologne Addition]
Ragh.	(PW) RAGHUVAṂŚA, Ausg. von STENZLER, wenn nicht ed. Calc. hinzuge- fügt wird. 
Raghuv.	(CSL PW) RAGHUVAṂŚA, Ausg. von STENZLER, wenn nicht ed. Calc. hinzuge- fügt wird. 
Rājan.	(PW) RĀJANIGHAṆṬU, Hdschr. (ROTH). 
Rājat.	(PW) RĀJATARAṂGIṆĪ. Die 6 ersten Bücher nach der Ausg. von TROYER. Die Beträge aus dem 7ten und 8ten Buche von KERN. 
Rāmat.	(CSL?) Rāmatāpanī, name of an Upaniṣad belonging to the Atharvaveda
Rasas.	(SCH) Rasas(adanabhāṇa) ed. Kāvyamālā Nr. 37.
Rasikar.	(CSL) Name of work
Rasikarañjana	(CSL) Name of work
Ratnam.	(PW) RATNAMĀLĀ. (ROTH). 
Ṛtus.	(PW) RṬUSAṂHĀRA, Ausg. von BOHLEN. 
Ṛtusaṃh.	(CSL PW) RṬUSAṂHĀRA, Ausg. von BOHLEN.
Rudraṭa, Kāvy.	Rudraṭa (with śatānanda), name of a writer on rhetoric (son of Vāmuka)
Rudraṭālaṃkāraṭ.	(PW) RUDRAṬĀLAṂKĀRAṬIPPAṆAKA, auch RUDRAṬAKĀVYĀLAṂKĀRAṬ. genannt (R. PISCHEL. ) 
ṚV.	(PW) ṚGVEDA (ROTH). 
ṚV. Prāt.	(PW) PRĀTIŚĀKHYA zum ṚGVEDA. 
S	[unknown]
S. S. S.	(PW) SAṂGITASĀRASAṂGRAHA, Calcutta 1932 (CAPELLER). 
Śabdar.	(CSL) Śabdaratnamālā, name of grammars and dictionaries.
Saddh. P.	(PW) SADDHARMAPUṆḌARĪKA (KERN) . 
Ṣaḍguruś.	(CSL) Ṣaḍguruśiṣya, name of a Commentator on Kātyāyana’s Ṛgvedasarvânukramaṇī
Sādh.	[unknown]
Saduktik.	(PW) SADUKTIKARṆĀMṚTA von ŚRĪDHARADĀSA, Hdschr. (AUFRECHT). 
Ṣaḍv. Br.	(PW) ṢAḌVIṂŚABRĀHMAṆA (WEBER). 
Sāh. D.	(PW) SĀHITYADARPAṆA in der Bibl. ind. 
Sāhityad.	(CSL) name of a treatise on literary or rhetorical composition by Viśvanātha-kavi-rāja 
Sāhityadarpaṇa	(CSL) name of a treatise on literary or rhetorical composition by Viśvanātha-kavi-rāja 
Śāk.	(PW) ŚĀKUNTALA, Ausg. von BÖHTLINGK, wenn nicht ausdrücklich PISCH. (PISCHEL) oder PRAMAC. (PREMACANDRA) hinzugefügt wird. 
Śāk. (Ch.)	(CSL PW) Śākuntala
Śāk. (Kāśm.)	(CSL) Śākuntala
Śāk. Ch.	(CSL PW) Śākuntala
Śāktān. Kap.	(CSL) Śāktānandataraṃgiṇī, name of work compiled for the use of the Śāktas from the Tantras and Purāṇas
Sam.	[unknown]
Sāmav. Br.	(PW) SĀMAVIDHĀNABRĀHMAṆA, Ausg. von BURNELL. 
Samay.	(SCH) Samay(amātṛkā) ed. Kāvyamālā Nr. 10. Mit Benutzung natürlich von J. J. Meyers Übersetzung. Sarasv(atlkaṇthābharaṇam).
Samayam.	(CSL SCH) Samay(amātṛkā) ed. Kāvyamālā Nr. 10. Mit Benutzung natürlich von J. J. Meyers Übersetzung. Sarasv(atlkaṇthābharaṇam).
Saṃhitop.	(CSL PW) SAṂHITOPANIṢAD, Ausg. von BURNELL.
Saṃhitopan.	(PW) SAṂHITOPANIṢAD, Ausg. von BURNELL. 
Śaṃk.	(PW) ŚAṂKARĀCĀRYA als Commentator verchiedener UPANIṢAD. 
Śaṃkaramiśra	(CSL) name of various authors (esp. of a poet and a philosopher, son of Bhavanātha)
Sāṃkhyak.	(PW) SĀṂKHYAKĀRIKĀ, Ausg. von WILSON. 
Sāṃkhyakār.	(CSL PW) SĀṂKHYAKĀRIKĀ, Ausg. von WILSON. 
Sāṃkhyapr.	(CSL PW) Sāṃkhyapravacana = Yogasūtra, or = Sāṃkhyasūtra
Sāṃkhyas.	(CSL) Sāṃkhyasūtra
Sāṃkhyatattvak.	(CSL) name of a commentary on the Sāṃkhyakārikā by Vācaspati-miśra.
Saṃkṣepaś.	(CSL) Saṃkṣepaśārīraka, a summary in verse of Śaṃkarâcārya’s Brahmasūtr-bhāṣya by Sarvajñâtman Mahāmuni 
Saṃsk. K.	(PW) ANANTADEVA’S SAṂSKĀRAKAUSTUBHA, obl. fol. 
Śāṇḍ.	(PW) The Aphorisms of SĀṆḌILYA in der Bibl. ind. 
Śāṅkh. Br.	(PW) ŚĀṄKHĀYANA’S BRĀHMAṆA (WEBER). 
Śāṅkh. Gṛhy.	(PW) ŚĀṄKHĀYANA’S GṚHYASŪTRA, herausg. von OLDENBERG in Ind. St. 15. 
Śāṅkh. Śr.	(PW) ŚĀṄKHĀYANA’S ŚRAUTASŪTRA (WEBER). 
Sarasv.	(CSL PW) SARASVATĪKAṆṬHĀBHARAṆA, Hdschr. (AUFRECHT).
Sarasvatīk.	(PW) SARASVATĪKAṆṬHĀBHARAṆA, Hdschr. (AUFRECHT). 
Sarasvatīkaṇṭh.	(CSL PW) SARASVATĪKAṆṬHĀBHARAṆA, Hdschr. (AUFRECHT).
Śārṅg.	(CSL PW) ŚĀRṄGADHARA’S SAṂHITĀ, Bombay 1853 (ROTH). 
Śārṅg. Saṃh.	(PW) ŚĀRṄGADHARA’S SAṂHITĀ, Bombay 1853 (ROTH). 
Śārṅgadharap.	(CSL) Śārṅgadharapaddhati, name of a poetical anthology
Sarvad.	(PW) SARVADARŚANASAṂGRAHA in der Bibl. ind. (KERN). 
Śāśv.	[unknown]
Śat. Br.	(PW) ŚATAPATHABRĀHMAṆA, nach WEBER’S Index. 
Śatr.	(PW) ŚATRUṂJAYAMĀHĀTMYA, Ausg. von WEBER. 
Saug.	(SCH) Saug(andhikākaraṇam) ed. Kāvyamālā Nr. 74, Bombay 1902.
Sāy.	(PW) SĀYAṆA. 
Schl.	(CSL) Friedrich Schlegel (1772-1829) German poet, literary critic, philosopher, philologist, and indologist.
Śīlāṅk.	(CSL PW) ŚĪLĀṄKA’S Commentar zum ĀCĀRĀṄGASŪTRA, Calcutta 1878 (JACOBI). 
Śīlāṅka	(PW) ŚĪLĀṄKA’S Commentar zum ĀCĀRĀṄGASŪTRA, Calcutta 1878 (JACOBI). 
Śiś.	(PW) ŚIŚUPĀLAVADHA, Calcutta 1815. 
Śiśup.	(CSL PW) ŚIŚUPĀLAVADHA, Calcutta 1815. 
Śiv. Vim.	(SCH) Śiv. Vim. = The Shiva Sūtra Vimarshinī (The Kashmir Series … Vol. I).
Śiva-P. (SK.)	(CSL) Śivapurāṇa, name of one of the 18 Puraṇas
ŚKdr.	(PW) ŚABDAKALPADRUMA. 
Śobh.	[unknown]
Spr.	(PW) Indische Sprüche, herausg. von O. BÖHTLINGK. 2te Aufl. Von 7614 an in Melanges asiatiques, T. VIII, S. 217. fgg. Ebendaselbst S. 203. fgg. stehen die durch "zu Spr. " bezeichneten Varianten. 
Śrīk.	(SCH) Śrīk(aṇthacaritam) ed. Kāvyamālā Nr. 3. Ist teilweise schon im pw verarbeitet.
Śrīkaṇṭh.	(CSL) Śrīkaṇṭhacarita, name of a poem written by Maṅkha
Śrīkaṇṭhacarita	(CSL) name of a poem written by Maṅkha
Śrīmālām.	[unknown]
Śṛṅg.	[unknown]
Śṛṅgārabh.	(CSL) Śṛṅgārabhedapradīpa, name of work
Śṛṅgārasarv.	(SCH) Śṛṅgārasarv(asvabhāṇa) ed. Kāvyamālā Nr. 78.
Śṛṅgārat.	(CSL) Śṛṅgārataṭinī, name of a work on rhetoric f. N. of a rhet. wk.&#13;&#10; or Śṛṅgārataraṃgiṇī, name of a Bhāṇa and other works.
Śṛṅgāravairāgyataraṃgiṇī	(CSL) name of a Jaina poem by Somaprabhâcārya.
Śṛṅgbh.	(SCH) Śṛṅgbh = Śṛṅgārabiūsaṇabhāṇa ed. Kāvyamālā Nr. 58.
Śṛṅgt.	(SCH) Śṛṅgt = Śṛṅgāratilakabhāṇa ed. Kāvyamālā Nr. 44.
Śrut.	(PW) ŚRUTABODHA in der Zeitschrift für die Kunde des Morgenlandes, Bd. IV. 
Subhadr.	(SCH) Subhadr(āharaṇa) ed. Kāvyamālā Nr. 9, Bombay 1888.
Subhāṣ.	(CSL PW) SUBHĀṢITARATNĀKARA, Bombay 1872. 
Subhāṣitar.	(PW) SUBHĀṢITARATNĀKARA, Bombay 1872. 
Subhāṣitaratnabhāṇḍāgāra	[unknown]
Subhāṣitāv.	(PW) SUBHĀṢITĀVALI von VALLABHADEVA, Hdschr. (AUFRECHT). 
Sud.	(PW) [unknown literary source]
Śuk.	(SCH) Śuk(asaptati) t(extus) s(implicior) resp. o(rnatior), meine Ausgaben.
Sukhāv.	(PW) SUKHĀVATĪVYŪHA nach der nocht nich erschienenen Ausg. von F. MAX MÜLLER.
Śūlap. Prāyaśc.	[unknown]
Śulbas.	(PW) ŚULBASŪTRA in der Zeitschirft The Pandit IX. X und New Series I (CAPELLER). 
Suparṇ.	(PW) SUPARṆĀDHYA, herausg. von ELIMAR GRUBE in Ind. St. 14. 
Sūryaś.	(SCH) Sūryaś(atakam) ed. Kāvyamālā Nr. 19.
Sūryas.	(PW) SŪRYASIDDHĀNTA in der Bibl. ind. 
Suśr.	(PW) SUŚRUTA (ROTRH). 
Svapnac.	(CSL?) Svapnacintāmaṇi, name of a work on oneiromancy.
Śvetāśv. Up.	(PW) ŚVETĀŚVATAROPANIṢAD in der Bibl. ind. 
T. S.	[unknown]
Taitt. Ār.	(PW) TAITTIRĪYĀRAṆYAKA in der Bibl. ind. 
Taitt. Br.	(CSL) Taittirīyabrāhmaṇa, the Brāhmaṇa of the Taittirīyas
Taitt. Up.	(PW) TAITTIRĪYOPANIṢAD in der Bibl. ind. 
Talavakāra-Br.	(CSL) Talavakārabrāhmaṇa, another name of Jaiminīya brāhmaṇa 
Tāṇḍya-Br.	(PW) TĀṆḌYABRĀHMAṆA in der Bibl. Im grossen Wörterbuch als PAÑCAV. BR. citirt. 
Tāran.	(CSL) Tāranātha, name of a Tibetan (living in the beginning of the 17th century; author of a history of Buddhism)
Tarkas.	(PW) TARKASAṂGRAHA, Allahabad 1849(ROTH). 
TBr.	(PW) TAITTIRĪYA BRĀHMAṆA (ROTH). 
Tejob. Up.	(PW) TEJOBINDŪPANIṢAD in der Bibl. ind. (GELDNER). 
Tithyād.	[unknown]
Trik.	(PW) TRIKĀṆḌAŚEṢA. 
TS.	(PW) TAITTIRĪYASAṂHITĀ (ROTH und WEBER). 
TS. Prāt.	(PW) PRĀTIŚĀKHYA zur TS. , Ausg. von WHITNEY. 
Ujjval.	(PW) UJJVALADATTA, Commentator der UṆĀDISŪTRA. 
Uṇādis.	(PW) UṆĀDISŪTRA, herausg. von AUFRECHT. 
Unm.	(CSL SCH) Unmattar(āghavam) ed. Kāvyamālā Nr. 17.
Unmattar.	(SCH) Unmattar(āghavam) ed. Kāvyamālā Nr. 17.
Unmattaragh.	(CSL SCH) Unmattar(āghavam) ed. Kāvyamālā Nr. 17.
Uttamac.	(PW) Ueber das UTTAMACARITRAKATHĀNAKAM, die Geschichte vom prinzen Trefflichst in Sitzungsserichte der Kön der Kön. Pr. Akademie der Ww- zu Berlin 1884, No. XVII. 
Uttar.	[unknown]
Uttarac.	[unknown]
Uttarādhy.	[unknown]
Uttarar.	(PW) UTTARARĀMACARITRA, nach zwei Ausgaben, Calcutta 1831 und 1862. 
Uttararāmach.	(CSL PW) (PW) UTTARARĀMACARITRA, nach zwei Ausgaben, Calcutta 1831 und 1862. 
V.	(SCH) V(ātsyāyana’s) Kāmasūtram. Die ed. Benares 1912 wird gelegentlich auch zitiert.
Vāgbh.	(PW) VĀGBHAṬA’S ĀYURVEDADARŚANA (ROTH). 
Vāgbhaṭa	(CSL PW) name of a writer on rhetoric (author of the Vāgbhaṭâlaṃkāra)
Vaij.	(SCH) Vaij(ayantī) ed. Oppert.
Vaitān.	(PW) VAITĀNASŪTRA, Ausg, von GARBE. 
Vaj.	(CSL PW) VAJRACCHEDIKĀ, herausgegeben von (F. MAX MÜLLER). 
Vajracch.	(PW) VAJRACCHEDIKĀ, herausgegeben von (F. MAX MÜLLER). 
Vall.	(CSL PW) Vallabha, name of a grammarian and various other writers and teachers
Vāmana, Kāvy.	(CSL) Vāmana, author of the Kāvyâlaṃkāravṛtti
Vāmanap.	(CSL) Vāmanapurāṇa, name of one of the 18 Purāṇas
Vāmanap. Kap.	(CSL) Vāmanapurāṇa, name of one of the 18 Purāṇas
Var. Bṛh. S.	(CSL PW) VARĀHAMIHIRA’S BṚHATSAṂHITĀ (KERN). 
Varāh. Bṛh.	(PW) VARĀHAMIHIRA’S BṚHAJJĀTAKA (KERN). 
Varāh. Bṛh. S.	(PW) VARĀHAMIHIRA’S BṚHATSAṂHITĀ (KERN). 
Varāh. Yogay.	(PW) VARĀHAMIHIRA’S YOGAYĀTRĀ, herausg. von KERN in Ind. St. 10. 14 und 15. 
Varāhap.	(CSL) Varāhapurāṇa, name of the fifteenth Purāṇa
Varāhap. Kap.	(CSL) Varāhapurāṇa, name of the fifteenth Purāṇa
Vardhamānac.	(PW) [unknown literary source]
Vās.	(PW) VĀSANTIKĀ, Hdschr. (CAPELLER). 
Vāsav.	(PW) VĀSAVADATTĀ in der Bibl. ind. 
Vāsavad.	(CSL PW) VĀSAVADATTĀ in der Bibl. ind. 
Vāstuv.	(PW) VIŚVAKARMA’S VĀSTUVIDYĀ, Hdschr (KERN). 
Vāyu-P.	(PW) VĀYUPURĀṆA, nach Citaten in andern Werken. 
Vedārthad.	(CSL) Vedārthadīpa, name of work or &#13;&#10; Vedārthadīpikā, name of work (by Ṣaḍguruśiṣya) 
Veṇīs.	(PW) VEṆĪSAṂHĀRA, Ausg. von GRILL (CAPELLER). 
Verz. d. B. H.	(PW) WEBER, Verzeichniss der Berliner Handschriften. 
Verz. d. Oxf. H.	(PW) AUFRECHT, Verzeichniss der Oxforder Handschriften. 
Vet. (U.)	(PW) VETĀLAPAÑCA VIṂŚATIKĀ, herausgegeben von HEINRICH UHLE. 
Viddh.	(PW) VIDDHAŚĀLABHAÑJIKĀKHYANĀṬIKĀ in der Zeitschrift PRATNAKAMRANANDINI(CAPELLER). 
Viddhaś.	(CSL PW) (PW) VIDDHAŚĀLABHAÑJIKĀKHYANĀṬIKĀ in der Zeitschrift PRATNAKAMRANANDINI(CAPELLER).
Viddhaśāl.	(CSL PW) (PW) VIDDHAŚĀLABHAÑJIKĀKHYANĀṬIKĀ in der Zeitschrift PRATNAKAMRANANDINI(CAPELLER).
Viddhaśālabh.	(CSL PW) (PW) VIDDHAŚĀLABHAÑJIKĀKHYANĀṬIKĀ in der Zeitschrift PRATNAKAMRANANDINI(CAPELLER).
Vijñ.	(CSL PW) Vijñāneśvara, name of an author,(-tantra, -vārttika, name of works) 
Vikr.	(PW) VIKRAMORVAŚĪ, Ausg. von BOLLENSEN. 
Vikram.	(CSL PW) VIKRAMORVAŚĪ, Ausg. von BOLLENSEN; or &#13;&#10; VIKRAMĀṄKADEVACARITA, Ausg. von BÜHLER. 
Vikramāṅkac.	(PW) VIKRAMĀṄKADEVACARITA, Ausg. von BÜHLER. 
Vīram.	(PW) VĪRAMITRODAYA, Khadirapura 1815(STENZLER) . 
Vīramitrodaya	(CSL PW) VĪRAMITRODAYA, Khadirapura 1815(STENZLER) . 
Viṣṇubh.	(SCH) Viṣṇubh(aktikalpalatā) ed. Kāvyamālā Nr. 31, Bombay 1892.
Viṣṇus.	(PW) VIṢṆUSŪTRA, zur Herausgabe vorbereitet von Y. JOLLY (JOLLY) 
Viṣṇusm.	(CSL) Viṣṇusmṛti, name of work
Viṣṇusmṛti	(CSL) name of work
Vivādar.	(CSL) Vivādaratnākara, name of a work on law 
Vivādaratn.	(CSL) Vivādaratnākara, name of a work on law 
Vivādaratnākara	name of a work on law 
Vop.	(PW) VOPADEVA’S MUGDHABODHA, herausgegeben und erklärt von O. BÖHTLINGK. 
VP.	(PW) VIṢṆUPURĀṆA ed. Bomb. 
Vṛṣabh.	(PW) VṚṢABHĀNUJA im 3ten und 4ten Bande des Pandit (CAPELLER). 
VS.	(PW) VĀJASANEYISAṂHITĀ (ROTH und WEBER). 
VS. Prāt.	(PW) PRĀTIŚĀKHYA zu VS in Ind. St. 4. 
Vyutp.	(PW) VYUTPATTI, ein Sanskrit-Tibetisches Wörterbuch aus dem TAÑJUR (SCHIEFNER). 
Wilson, Sel. W.	(PW) Select Works of H. H. WILSON. 
Wilson, Sel. Works	(CSL PW) Select Works of H. H. WILSON. 
Y.	(SCH) Y(aśodhara’s) Kommentar zum Kāmasūtram.
Yājñ.	(PW) YĀJÑAVALKYA’s Gesetzbuch, Ausg. von STENZLER. 
Yaśastilakam.	[unknown]
Yogas.	(PW) YOGASŪTRA. 
Yogavās.	(CSL) Yogavāsiṣṭha, name of a work also called Vāsiṣṭharāmāyaṇa
Yudh.	(SCH) Yudh(iṣṭhiravijaya) ed. Kāvjamālā.
Zach.	(CSL PW) Theodore Zachariae (1851-1934), German Indologist.
ZDMG	(CSL) Zeitschrift für die Kunde des Morgenlandes
