Adhikaraṇamālā	Adhikaraṇaratnamālā, 1913, a treatise in the मीमांसा philosophy
Ādipurāṇa	name of the Brahma-purāṇa
Agni P.	Agni Purāṇa
Ait. Br.	Aitareya Brāhmaṇa (Bombay)
Ak.	Amarakoṣa
Amara	Name of Amarasiṃha (Author)
Ā. L.	Ānandalaharī
Amaru.	Amaruśataka
Āpast.	Āpastamba
A. R.	Anargharāghava (published in the Kāvyamālā)
Āry. S.	Āryavidyāsudhākara (Bombay)
Āryā S.	Āryāsaptaśatī (published in the Kāvyamālā)
Aśvad.	Aśvadhāṭī (published in the Subhāṣitaratnākara)
Āśval.	Āśvalāyana’s Sūtras
Atri	Atri (Author of several Vedic hymns)
Av.	Atharva-veda
Baudhāy.	Baudhāyana
Bg.	Bhagavadgītā (Bombay)
Bh.	Bhartṛhari’s three Śatakas (the figures 1., 2., 3. after Bh. denoting Śṛṅgāraº, Nītiº, and Vairāgyaº)
Bhartṛ.	Bhartṛhari (Author)
Bhartṛhari	Bhartṛhari (Author)
Bharata	Bharatamuni, author of  Nāṭyaśāstra
Bhav. P.	Bhaviṣyottara Purāṇa
Bhāg.	Bhāgavata (Bombay)
Bhāminīvilāsa	  poem by Jagannātha Paṇḍitarāja 
Bhār. Ch.	Bhāratacampū (Bombay)
Bhāṣā P.	Bhāṣāpariccheda
Bhāva P.	Bhāvaprakāśa
Bīj.	Bījagaṇita
Bk.	Bhaṭṭikāvya
B. R.	Bālarāmāyaṇa (Benares)
B. and R.	Böthlingk and Roth
Bṛ. S.	Varāhamihira’s Bṛhatsaṃhitā
Bṛhat Saṃhitā	Varāhamihira’s Bṛhatsaṃhitā
Bṛ. Kath.	Bṛhatkathā
Br. Sūt.	Brahmasūtras
Bṛ. Up.	Bṛhadāraṇyakopaniṣad
Bṛ. Ār. Up.	Bṛhadāraṇyakopaniṣad
Bṛhaspati	Bṛhaspati (Author)
Bv.	Bhāminīvilāsa (Bombay)
Caraka	Caraka (Author)
Caṇḍ. K.	Caṇḍakauśika
Chand. M.	Chandomañjarī
Ch. M.	Chandomañjarī
Chandr.	Candrāloka
Candrāloka	Candrāloka, name of work on rhetoric
Chāṇ.	Cāṇakyaśataka
Chāt.	Cātakāṣṭaka (in two parts.)
Ch. P.	Caurapañcāśikā
Ch. Up.	Chāndogyopaniṣad
Chān. Up.	Chāndogyopaniṣad
Colebr.	Colebrooke (European author)
Dāy.	Dāyabhāga
Dāy. B.	Dāyabhāga
Dāyabhāga	Dāyabhāga (Work)
D. Bhāg.	Devībhāgavata
Dakṣa.	Dakṣamṛti, an ancient treatise in Dharmaśāstra
Dhan. V.	Dhanaṃjayavijaya
Dhātupāṭha	Dhātupāṭha of Pāṇini
Dharm.	Dharmaviveka
Dhūrt.	Dhūrtasamāgama
Dhūrtas.	Dhūrtasamāgama (Work of Drama)
Dīpikā.	Muhūrta Dīpikā
Dk.	Daśakumāracarita (Bombay)
D. R.	Daśarūpa (Hall’s Edition)
Dṛ. Ś.	Dṛṣṭāntaśataka
Gadādhara.	Gadādhara (Author)
Gaṅgāṣṭaka	A generic work under Stotra category, praising the River Gaṅgā.
Gaṇapāṭha	Gaṇapāṭha (Work by Pāṇini)
Gauḍapāda	Gauḍapāda (Author)
Gaut. S.	Gautamasūtra
Gaut. Sūt.	Gautamasūtra
Gautama	Gautama (Author)
Ghaṭ.	Ghaṭakarparakāvya
Gīt.	Gītagovinda
Gobhila	Gobhila (Author)
G. L.	Gaṅgālaharī
G. M.	Gaṇaratnamahodadhi of Vardhamāna
Golādh.	Golādhyāya
H.	Hitopadeśa (Nirṇaya Sāgara Edition)
Halāy.	Halāyudha
Hariv.	Harivaṃśa (Poem)
Harivaṃśa	Harivaṃśa (Poem)
Hch.	Harṣacarita
H. D.	Haṃsadūta
H. Pr.	Hitopadeśa prastāvikā
Hem.	Hemacandra
Hemacandra	Hemacandra (Jaina Author)
Hemādri	Hemādri (Author)
Haima	the Abhidhānacintāmaṇi of Hemacandra
Hārāvalī	Hārāvalī (Work)
Hārīta	Hārīta (Author)
Hist. Anc. Lit.	(Max Müller's) History of Ancient Sanskrit literature
Īśop.	Īśopaniṣad
J. N. V.	Jaiminīyanyāyamālāvistara (Goldstücker’s Edition)
Jābāli	Jābāli (Author)
Jagaddhara	Jagaddhara (Author)
Jag.	Jagannātha Pandit
Jagannātha	Jagannātha Pandit
Jaimini S.	Jaiminisūtra (Work)
Jaimini's Sūtra	Jaiminisūtra (Work)
Jyotiṣa	Raghunandana's Jyotiṣatattva
K.	Kādambarī (Bombay)
Kaiyaṭa	Kaiyaṭa (Author)
Kalhaṇa	Kalhaṇa (Author)
Kālikā P.	Kālikāpurāṇa
Kālikā Purāṇa	Kālikāpurāṇa
Kāmandaka	Kāmandaka (Author)
Karka	Karka (Author)
Kām.	Kāmandakinītisāra
Kāśi.	Kāśikāvṛtti (Benares)
Kāśikā.	Kāśikāvṛtti
Karpūr.	Karpūramañjarī (published in the Kāvyamālā)
Kāśyapa	Kāśyapa (Author)
Kaṭh.	Kaṭhopaniṣad
Kāty.	Kātyāyana
Kātyāyana	Kātyāyana (Author)
Kauś.	Kauśikasūtra
Kauṣ. Br.	Kauṣītaki Brāhmaṇa
Kauṣ. Up.	Kauṣītakyupaniṣad
Kauṭilya	Kauṭilya (grammarian)
Kāv.	Kāvyādarśa
Kāvyāl.	Kāvyālaṃkāra (published in the Kāvyamālā)
Ken.	Kenopaniṣad
Ki.	Kirātārjunīya
Kīr. K.	Kīrtikaumudī (Bombay)
K. P.	Kāvyaprakāśa
K.R.	Kavirahasya
Kavirahasya	Kavirahasya (Work)
Kavirāja	A 12th century poet, who authored Rāghavapāṇḍavīyam
Ks.	Kathāsaritsāgara
Ku.	Kumārasambhava (Bombay)
Kull.	Kullūka
Kumārila	Kumārila (Author)
Kusum.	Kusumāñjali
Kuval.	Kuvalayānanda
Kuvalayānanda	Kuvalayānanda (Work)
Līlā.	Līlāvatī
Līlāvatī	Līlāvatī (Work by Bhāskarâcārya)
M.	Mālavikāgnimitra (Bombay)
Mādh. N.	Mādhavanidāna
Mahān.	Mahānāṭaka
Māl.	Mālatīmādhava (Bombay)
Malli.	Mallinātha
Māṇḍ.	Māṇḍūkyopaniṣad
Māṇḍ. Up.	Māṇḍūkyopaniṣad
Mārk. P.	Mārkaṇḍeya Purāṇa
M. W.	Monier-Williams Sanskrit-English Dictionary
Madhusūdana	Madhusūdana (Author(s))
Mahānāṭaka	Mahānāṭaka (a drama)
Maṅgalāṣṭaka	Maṅgalāṣṭaka (Hymn)
Manoramā	Manoramā (various works)
Mb.	Mahābhārata (Bombay)
Mbh.	Mahābhāṣya (Bombay)
Me.	Meghadūta (Bombay)
Medhātithi	Medhātithi (Author)
Med.	Medinīkośa
Medinī	Medinīkośa
Mit.	Mitākṣarā (Bombay)
Mīm.	Mīmāṃsā
Mīmāmsā	Pūrva-mīmāṃsā 
Mk.	Mṛcchakaṭikā
Moha M.	Mohamudgara
Ms.	Manusmṛti
Mu.	Mudrārākṣasa (Bombay)
Mugdha.	Mugdhabodha
Muhūrta.	Muhūrtacintāmaṇi
Muṇḍ.	Muṇḍakopaniṣad
Mv.	Mahāvīracarita (Borooah’s Edition),
Muktā.	(Nyāyasiddhānta)muktāvali
N.	Naiṣadhacarita
Nāg.	Nāgānanda
Naiṣadha.	Naiṣadhacarita (Work)
Naiṣadha Carita	Naiṣadhacarita (Work)
Nala.	Nalopākhyāna (Bombay)
Nalod.	Nalodaya
Nārada	Nārada (Author)
Nīlakaṇṭha	Nīlakaṇṭha (Author)
Nir.	Nirukta
Nīti.	Nītisāra
Nītipr.	Nītipradīpa
Nyāya S.	Nyāyasūtra by Gautama
Nyāya Sūtra	Nyāyasūtra by Gautama
P.	Pāṇini’s Aṣṭādhyāyī
Pad. D.	Padāṅkadūta
Padma Purāṇa	Padma Purāṇa (Work)
Pañcadaśī	Pañcadaśī (Several Works)
Parāśara	Parāśara (Author)
Paribhāṣenduśekhara	Paribhāṣenduśekhara (Work)
Pat. Sūt.	Patañjali Sūtra (Work)
Pat. Sūtra	Patañjali Sūtra (Work)
P. P.	Pārvatīpariṇaya
P. R.	Prasannarāghava
Prab.	Prabodhacandrodaya (Bombay)
Praśna. Up.	Praśnopaniṣad
Prācetasa.	Prācetasastava (Work)
Praśn. Up.	Praśnopaniṣad
Praśna Up.	Praśnopaniṣad
Pratāparudra	Pratāparudra (Author)
Priy. D.	Priyadarśikā (Bombay)
Pt.	Pañcatantra (Bombay)
Pūjā Mantra	A generic invocation used as Bhūtaśuddhi before taking up any work- esp. the Pūjā during festivals or other such sacred works
Pūjāmantra	A generic invocation used as Bhūtaśuddhi before taking up any work- esp. the Pūjā during festivals or other such sacred works
Puṣpadanta	Puṣpadanta (Author)
Rāghavānanda	Rāghavānanda (Author)
R.	Raghuvaṃśa (Bombay)
Rāj. P.	Rājapraśasti
Rāj. T.	Rājataraṅgiṇī
Rām.	Rāmāyaṇa (Bombay)
Ras. M.	Rasamañjarī
Rasamañjarī	Rasamañjarī (Work)
Ratn.	Ratnāvalī (Bombay)
R. G.	Rasagaṅgādhara (published in the Kāvyamālā)
Rāyamukuṭa	Rāyamukuṭa (Author)
Rs.	Ṛtusaṃhāra (Bombay)
Rv.	Ṛgveda (Max Müller’s Edition)
Śabarasvāmin	Śabarasvāmin (Author)
Ś.	Śakuntalā (Bombay)
Śabdak.	Śabdakalpadruma
Śabdārṇava	Śabdārṇava (Work)
Sāṅ. K.	Sāṃkhyakārikā
Sāṅkhya K.	Sāṃkhyakārikā
Sāṅkhya	Sāṃkhyakārikā ?
Sāṅ. S.	Sāṃkhyasūtra
Śaṅkara	Śaṃkarācārya (Author)
Sandhyā Mantra	Saṃdhyā Mantra (Work)
Saṃdhyā Mantra	Saṃdhyā Mantra (Work)
Śānti.	Śāntiśataka by Śilhaṇa
Śāntilakṣaṇa	A Buddhist work?
Sāv.	Sāvitryupākhyāna
Sar. K.	Sarasvatīkaṇṭhābharaṇa
Saralā	Saralā (Work)
Sarva. S.	Sarvadarśanasaṃgraha
Sarva.	Sarvadarśanasaṃgraha 
Sar. S.	Sarvadarśanasaṃgraha
Śat. Br.	Śatapatha Brāhmaṇa
Sāy.	Sāyaṇa (Author)
Sāyaṇa	Sāyaṇa (Author)
Ś. B.	Śārīrabhāṣya
S. D.	Sāhityadarpaṇa
Śi.	Śiśupālavadha
Sid. Mukt.	Siddhāntamuktāvalī
Sid. Śir.	Siddhāntaśiromaṇi
Śik.	Pāṇinīya Śikṣā 
Śikṣā	Pāṇinīya Śikṣā 
Śiva P.	Śivapurāṇa
Sk.	Siddhānta-Kaumudī (Bombay)
Skanda P.	Skanda Purāṇa
Smṛti.	Smṛtitattvam, name of a legal wk. by Raghunandana
Śrāddha Mantra	The mantra recited during one of the pāka-yajña-saṃsthās, as mentioned in Gautama-dharma-sūtra. These are Aṣṭakā, Pārvaṇa, Śrāddha, Śrāvaṇī, Āgrahāyaṇī, Caitrī, and Āśvayujī.
Śrāvaṇī Mantra	The mantra recited during one of the pāka-yajña-saṃsthās, as mentioned in Gautama-dharma-sūtra. These are Aṣṭakā, Pārvaṇa, Śrāddha, Śrāvaṇī, Āgrahāyaṇī, Caitrī, and Āśvayujī.
Śrīdhara	Śrīdhara (Author)
S. L.	Sudhālaharī (published in the Kāvyamālā)
Śrut.	Śrutabodha
Ś. Til.	Śṛṅgāratilaka
Śukra N.	Śukranītisāra
Śukra.	Śukranītisāra
Subh.	Subhāṣitaratnākara (Bombay)
Subhāṣ.	Subhāṣita
Subhāṣita	Subhāṣita 
Subh. Ratn.	Subhāṣitaratnabhāṇḍāgāra (Bombay)
Sūrya S.	Sūryasiddhānta
Suśr.	Suśruta
Suśruta	Suśruta (Author)
Sv.	Sāmaveda
Śvet. Up.	Śvetāśvataropaniṣad
Śvet.	Śvetāśvataropaniṣad
Śyāmāstava	A stava (stuti) mentioned in the Tantric text Śyāmārahasyatantra
T. Up.	Taittirīya Upaniṣad
Tāṇḍya Br.	Tāṇḍya Brāhmaṇa
Tāṇḍya.	Tāṇḍya Brāhmaṇa
Tantra.	Tantrasāra ?
Tarka K.	Tarkakaumudī (Bombay)
Trik.	Trikāṇḍaśeṣa
T. S.	Tarkasaṃgraha (Bombay)
Tv.	Tārānātha’s Vācaspatyam
U.	Uttararāmacarita
Udb.	Udbhaṭa
Udbhaṭa	Udbhaṭa (Author)
Ud. D.	Uddhavadūta
Ud. S.	Uddhavasaṃdeśa
Ujjval.	Ujjvaladatta
Ujjvalamaṇi	Ujjvalanīlamaṇi, a treatise on Skt. Poetics by Rūpagosvāmin
Uṇ.	Uṇādisūtras
Uṇādisūtras	Uṇādisūtras
Up.	Upaniṣad
Uśanas	Uśanas (Author)
V.	Vikramorvaśīyam (Bombay)
Vāgb.	Vāgbhaṭa
Vaiś.	Vaiśeṣika
Vaiś. Sūt.	Vaiśeṣikasūtras
Vaijayantī	Vaijayantī (Work)
Vāj.	Vājasaneyi Saṃhitā
Vāk. P.	Vākyapadīya
Vāyu.	Vāyu Purāṇa
Vall. Subh.	Vallabhadeva’s Subhāṣitāvali (Bombay)
Vās.	Vāsavadattā (Hall’s Edition)
Vasiṣṭha	Vasiṣṭha (Author)
Vb.	Viddhaśālabhañjikā (Bombay)
Ve.	Veṇīsaṃhāra
Vedānta P.	Vedāntaparibhāṣā
Vedānta	Vedāntasāra, a work by Sadānanda, published by GA Jacob
V. Paribhāṣā	Vedāntaparibhāṣā (Work)
Vedānta S.	Vedanta Sūtra, also known as Brahma Sūtra
Vedāntasāra	Vedāntasāra (Work)
Vet.	Vetālapañcavimśati
Vid.	Vidagdhamukhamaṇḍana
Vikr.	Vikramāṅkadevacarita (Bombay)
Vīr. M.	Vīramitrodaya
V. May.	Vyavahāramayūkha (Mr. Mandlik’s Edition)
Vop.	Vopadeva (Author)
Bop.	Bopadeva (= Vopadeva)
Vopadeva	Vopadeva (Author)
Bopadeva	Vopadeva (Author)
V. P.	Viṣṇu Purāṇa
Viṣṇu P.	Viṣṇu Purāṇa
Viṣṇu Smṛti	Viṣṇusmṛti, one of the ancient texts in Dharmaśāstra
Viṣṇu.	Viṣṇusmṛti, one of the ancient texts in Dharmaśāstra
Viśva	Viśvakośa, lexical work by Maheśvara
V. Ratn.	Vṛttaratnākara
Vṛnd. Ś.	Vṛndāvanaśataka
V. Sah.	Viṣṇusahasranāman
V. Sahas.	Viṣṇusahasranāman
Vyāsa	Vyāsasmṛti, one of the ancient texts in Dharmaśāstra
Yādava	Yādava (Author)
Y.	Yājñavalkya (Mr. Mandlik’s Edition)
Yama	Yamasmṛti
Yoga S.	Yogasūtras
Yv.	Yajurveda
Yaj.	Yajurveda
