Abh	Abhidharmakośa, transl. LaVallée Poussin, Paris and Louvain, 1923—31; many technical words cited from Index, transl., and notes. References, as in the Index, are to Book (of the original) and page of the translation.
Abh.	Abhidharmakośa, transl. LaVallée Poussin, Paris and Louvain, 1923—31; many technical words cited from Index, transl., and notes. References, as in the Index, are to Book (of the original) and page of the translation.
Abh. AW Berlin. ph.-h. Kl., 1949, Nr. 1 (1950)	?
AbhGGW, ph.-h. Kl., 3te Folge, Nr. 29, 30 (1944, 1948)	?
Abhidh-s.	Abhidhammatthasaṃgaha (Pali).
Abhidh.	Abhidharmakośa, transl. LaVallée Poussin, Paris and Louvain, 1923—31; many technical words cited from Index, transl., and notes. References, as in the Index, are to Book (of the original) and page of the translation.
Abhidh.p.	Abhidharmakośa, transl. LaVallée Poussin, Paris and Louvain, 1923—31; many technical words cited from Index, transl., and notes. References, as in the Index, are to Book (of the original) and page of the translation.
AbhidhK	Abhidharmakośa, transl. LaVallée Poussin, Paris and Louvain, 1923—31; many technical words cited from Index, transl., and notes. References, as in the Index, are to Book (of the original) and page of the translation.
AbhidhK LaV-P.	Abhidharmakośa, transl. LaVallée Poussin, Paris and Louvain, 1923—31; many technical words cited from Index, transl., and notes. References, as in the Index, are to Book (of the original) and page of the translation.
AbhidhK LaV.-P.	Abhidharmakośa, transl. LaVallée Poussin, Paris and Louvain, 1923—31; many technical words cited from Index, transl., and notes. References, as in the Index, are to Book (of the original) and page of the translation.
AbhidhK.	Abhidharmakośa, transl. LaVallée Poussin, Paris and Louvain, 1923—31; many technical words cited from Index, transl., and notes. References, as in the Index, are to Book (of the original) and page of the translation.
AbhidhK. (vyā.) LaV-P.	Abhidharmakośa, transl. LaVallée Poussin, Paris and Louvain, 1923—31; many technical words cited from Index, transl., and notes. References, as in the Index, are to Book (of the original) and page of the translation.
AbhidhK. (vyākhyā) LaV-P.	Abhidharmakośa, transl. LaVallée Poussin, Paris and Louvain, 1923—31; many technical words cited from Index, transl., and notes. References, as in the Index, are to Book (of the original) and page of the translation.
AbhidhK. Index	Abhidharmakośa, transl. LaVallée Poussin, Paris and Louvain, 1923—31; many technical words cited from Index, transl., and notes. References, as in the Index, are to Book (of the original) and page of the translation.
AbhidhK. LaV-P.	Abhidharmakośa, transl. LaVallée Poussin, Paris and Louvain, 1923—31; many technical words cited from Index, transl., and notes. References, as in the Index, are to Book (of the original) and page of the translation.
AbhidhK. LaV-P. Index	Abhidharmakośa, transl. LaVallée Poussin, Paris and Louvain, 1923—31; many technical words cited from Index, transl., and notes. References, as in the Index, are to Book (of the original) and page of the translation.
AbhidhK. Vy.	Abhidharmakośa, transl. LaVallée Poussin, Paris and Louvain, 1923—31; many technical words cited from Index, transl., and notes. References, as in the Index, are to Book (of the original) and page of the translation.
Abhidhānappadīpikā	?
Abhisamayālaṃkārāloka (GOS 62)	?
Acharya, Dict. Hind. Arch.	Dict(ionary of) Hindu Arch(itecture), Oxford Univ. Press, n.d. [1927?].
Acharya, Dict. Hindu Arch.	Dict(ionary of) Hindu Arch(itecture), Oxford Univ. Press, n.d. [1927?].
Acharya, Dict. Hindu Architecture	Dict(ionary of) Hindu Arch(itecture), Oxford Univ. Press, n.d. [1927?].
Acharyaʼs Dict. Hind. Arch.	Dict(ionary of) Hindu Arch(itecture), Oxford Univ. Press, n.d. [1927?].
Addendum	?
AdP	Sten Konow, Central Asian Fragments of the Aṣṭādaśasāhasrikā, in Memoirs of the Archaeological Survey of India, No. 69, 1942. Only a few rare and important words.
AdP Konow MASI 69	Sten Konow, Central Asian Fragments of the Aṣṭādaśasāhasrikā, in Memoirs of the Archaeological Survey of India, No. 69, 1942. Only a few rare and important words.
AdP, Konow MASI 69	Sten Konow, Central Asian Fragments of the Aṣṭādaśasāhasrikā, in Memoirs of the Archaeological Survey of India, No. 69, 1942. Only a few rare and important words.
AdP, Konow, MASI 69	Sten Konow, Central Asian Fragments of the Aṣṭādaśasāhasrikā, in Memoirs of the Archaeological Survey of India, No. 69, 1942. Only a few rare and important words.
AGS	?
Ait. Br.	Aitareya Brāhmaṇa.
Amara	Amarakośa.
Amarak.	Amarakośa.
Amarakośa	Amarakośa.
AN	Aṅguttaranikāya (Pali).
AN comm.	?
Andersenʼs Reader, Glossary	?
Ap	Apabhraṃśa; Apadāna (Pali text).
Apte	Apte, Studentʼs Sanskrit-English Dictionary (1922).
ApŚ	Apastamba Śrauta Sūtra.
Arthaśāstra	?
AsP	Aṣṭasāhasrikā-prajñāpāramitā, ed. Rajendralala Mitra, Calcutta, 1888.
Atthasālinī	?
Aufrecht	?
Aung and Rhys Davids, Compendium of Philos.	?
AV	Atharvaveda.
Av	Avadāna-śataka, ed. Speyer, 2 vols., St. Petersburg, 1902, 1906; transl. Feer, Annales du Musée Guimet 18 (1891).
Av, Index	?
AV.	Atharvaveda.
Av.	Atharvaveda.
AVPariś.	Atharvaveda Pariśiṣṭa.
Aśoka, Rock Ed.	?
Aśokan u(y)yāma, Rock Ed.	?
Aśokaʼs 4th Rock Edict, Dhauli-Jaugada version	?
Āṭānāṭika Sūtra	?
B.	Saddharmapuṇḍarīka, ed. Kern and Nanjio, St. Petersburg, 1912, abbreviated KN; supplementary references to ed. of Wogihara and Tsuchida, Tokyo, 1934—35, abbreviated WT; fragments of ‘Kashgar’ or Central Asiatic recension, ed. Thomas and Lüders, ap. Hoernle, MR 133 ff., 144 ff.; others, ed. LaVallée Poussin, JRAS 1911, 1070 ff.; transl. Burnouf (Lotus de la Bonne Loi, Paris, 1852), and Kern (SBE 21, Oxford, 1884). Tibetan citations chiefly from block-print in my possession, partly from WT. When my work was practically ready for print, my colleague Professor Rahder received, and lent to me, the photostatic reproduction of the ms. referred to by WT as Ḱ. It has been cited a very few times. The quotations from it in WT seem to be very inaccurate.
B. and R.	Böhtlingk and Roth Grosses Petersburger Wörterbuch
B.Pr.S.	?
B.S.	?
Bailey, BSOS	Bailey in Bulletin of the School of Oriental (and African) Studies, London.
Bailey, JRAS	Bailey in Journal of the Royal Asiatic Society.
Barua and Mitra	?
Baruch, Beiträge zum Saddharmapuṇḍarīkasūtra	?
Bbh	Bodhisattvabhūmi, ed. Wogihara, Tokyo, 1930—36. Includes the editorʼs dissertation, Lexikalisches aus der Bodhisattvabhūmi, which is referred to as Wogihara, Lex.
Bbh.	Bodhisattvabhūmi, ed. Wogihara, Tokyo, 1930—36. Includes the editorʼs dissertation, Lexikalisches aus der Bodhisattvabhūmi, which is referred to as Wogihara, Lex.
Bca.ṭ.	Bodhicaryāvatāra-ṭīkā, ed. LaVallée Poussin, Brussels, 1898. Technical terms cited from Index.
Bcp.	?
Bcṭ	Bodhicdaryāvatāra-ṭīkā, ed. LaVallée Poussin, Brussels, 1898. Technical terms cited from Index.
Bcṭ.	Bodhicdaryāvatāra-ṭīkā, ed. LaVallée Poussin, Brussels, 1898. Technical terms cited from Index.
Bendall	?
Bendall and Rouse	Śikṣāsamuccaya, ed. Bendall, St. Petersburg, 1897—1902; transl. Bendall and Rouse, London, 1922.
Bendall and Rouse in Śikṣ Transl.	Śikṣāsamuccaya, ed. Bendall, St. Petersburg, 1897—1902; transl. Bendall and Rouse, London, 1922.
Bendall and Rouse Transl.	Śikṣāsamuccaya, ed. Bendall, St. Petersburg, 1897—1902; transl. Bendall and Rouse, London, 1922.
Bendall and Rouse, note in Transl.	Śikṣāsamuccaya, ed. Bendall, St. Petersburg, 1897—1902; transl. Bendall and Rouse, London, 1922.
Bendall and Rouse, Transl.	Śikṣāsamuccaya, ed. Bendall, St. Petersburg, 1897—1902; transl. Bendall and Rouse, London, 1922.
Bendall and Rouse, Śikṣ	Śikṣāsamuccaya, ed. Bendall, St. Petersburg, 1897—1902; transl. Bendall and Rouse, London, 1922.
Bendall and Rouse, Śikṣ Transl.	Śikṣāsamuccaya, ed. Bendall, St. Petersburg, 1897—1902; transl. Bendall and Rouse, London, 1922.
Bendall Śikṣ	Śikṣāsamuccaya, ed. Bendall, St. Petersburg, 1897—1902; transl. Bendall and Rouse, London, 1922.
Bendall, JRAS, N.S. 12 (1880)	Bemdall in Journal of the Royal Asiatic Society.
Bendall, Śikṣ	Śikṣāsamuccaya, ed. Bendall, St. Petersburg, 1897—1902; transl. Bendall and Rouse, London, 1922.
Bendall-Rouse	Śikṣāsamuccaya, ed. Bendall, St. Petersburg, 1897—1902; transl. Bendall and Rouse, London, 1922.
Bendallʼs note	?
Bh.G.	?
Bhad	Bhadracarī, ed. Watanabe, Leipzig, 1912. Identical with Gv 543.9—548.2. Cited by numbered verses.
Bhav.	Bhavisattakahā (Ap.), ed. Jacobi (1918).
Bhav. (Jacobi)	Bhavisattakahā (Ap.), ed. Jacobi (1918).
Bhaṭṭ.	?
Bhattacharya, GOS	?
BhG.	Bhagavad Gītā.
BhP.	?
Bhāg.P.	Bhāgavata Purāṇa.
BhāgP.	Bhāgavata Purāṇa.
Bhīk	Bhikṣunī-karmavācanā, ed. Ridding and LaVallée Poussin, BSOS 1, Part 3, 123—143. Cited by page and line of the manuscript as reproduced in ed.
Bimbisārasūtra, Waldschmidt, Kl. Skt. Texte 4	?
Bloomfield, Mūladeva, Proc. Am. Philos. Soc.	?
Bodhicaryāv.	Bodhicdaryāvatāra-ṭīkā, ed. LaVallée Poussin, Brussels, 1898. Technical terms cited from Index.
Bodhicaryāvatārapañjikā (Bibl. Ind.)	Bodhicdaryāvatāra-ṭīkā, ed. LaVallée Poussin, Brussels, 1898. Technical terms cited from Index.
Bodhicaryāv. pañjikā	 ?
Boehtlingk	?
BR	Boehtlingk and Roth, Sanskrit Wörterbuch.
BR.	Boehtlingk and Roth, Sanskrit Wörterbuch.
Brahmadatta Jāt.	?
BSOS 1	Bulletin of the School of Oriental (and African) Studies, London.
Bu.v.	Buddha-vaṃsa (Pali).
Buddhac.	Buddhacarita, ed. Johnston, Calcutta, 1935. The language is standard Skt.; a few words, chiefly religious, are cited by chapter and verse.
Buddhacarita	Buddhacarita, ed. Johnston, Calcutta, 1935. The language is standard Skt.; a few words, chiefly religious, are cited by chapter and verse.
Buddhacarita (Johnston)	Buddhacarita, ed. Johnston, Calcutta, 1935. The language is standard Skt.; a few words, chiefly religious, are cited by chapter and verse.
Burlingame	?
Burlingame, HOS	?
Burlingame, JRAS	Burlingame in Journal of the Royal Asiatic Society.
Burnouf	Eugène Burnouf, 1801-1852, French indologist and orientalist.
Burnouf Intr.	?
Burnouf Introd.	?
Burnouf, Intr.	Introduction à lʼhistoire du bouddhisme indien (1844).
Burnouf, Introd.	?
Burnouf, Introduction	?
Burnouf, Lotus	transl. of SP, q.v. in preceding list.
Burnoufʼs note, Lotus	?
Burrow, BSOS	Burrow in Bulletin of the School of Oriental (and African) Studies, London.
Burrow, Kharoṣṭhī Documents	?
Bv	Buddha-vaṃsa (Pali).
Bṛh.Ar.U.Mādhy.	?
BṛhU	?
BṛhU.	?
Campeyya-Jāt.	?
Cappeller, HOS 15, Glossar	?
Car.	Caraka.
Caraka	Caraka.
Cath. Miss. Dict.	the Tibetan Dictionary of the French Catholic Mission.
Catudvāra Jāt.	?
Ch.U.	?
Ch.Up.	?
Chakravarti	Udānavarga; chap. 1—21, ed. Chakravarti (1930; except ch. 4, for which see Lévi, JAs. X. 20, 1912, 203 ff.); ch. 29, ed. Pischel, SBBA 1908, 968 ff.; ch. 30, 31, 32, ed. LaVallée Poussin, JRAS 1912, 369 ff. Cited by chapter and verse.
Charpentier IA 57 (1928)	?
Charpentier	?
Childers	Dictionary of the Pali Language, R. C. Childers.
Colebrooke, Essays	?
Colebrooke, Misc. Essays	?
Compendium of Philosophy	?
Coomaraswamy, Ars Islamica X (1943).	?
Cowell	?
Cowell and Neil (Index to Divy)	Divyāvadāna, ed. Cowell and Neil, Cambridge, 1886.
CPD	Andersen and Smith, Critical Pali Dictionary (Vol. 1), Copenhagen, 1924 ff.
Das	S. C. Das, Tibetan-English Dictionary.
Das, Dict.	S. C. Das, Tibetan-English Dictionary.
Das, Tib. Dict.	S. C. Das, Tibetan-English Dictionary.
Daśak.	Daśakumāracarita.
Dbh	Daśabhūmikasūtra, ed. Rahder, Paris and Louvain, 1926.
Dbh.	?
Dbh.g.	id. (Gāthā portion) ed. (Rahder and) Susa, Eastern Buddhist, 5.337 ff. and 6.51 ff., cited from reprint with consecutively numbered pages 1—58; the pages of the reprint are cited first, then in parentheses the pages of the original, then the line on each page.
Dbs	Daśabalasūtra, in Waldschmidt, Kl. Skt. Texte 4, 209 ff.
Deśīn.	Deśīnāmamālā, ed. Pischel, Bombay, 1880.
Dh	Dharmasaṃgraha, ed. Müller, Oxford, 1885. Cited by section numbers.
Dh.	Dharmasaṃgraha, ed. Müller, Oxford, 1885. Cited by section numbers.
Dharmas	Dharmasaṃgraha, ed. Müller, Oxford, 1885. Cited by section numbers.
Dhauli Sep.	?
Dhp	Dhammapada (Pali); Dhp. c(omm.), commentary on Dhp.; Fausb. refers to Fausböllʼs ed. of Dhp.
Dhp.	Dhammapada (Pali); Dhp. c(omm.), commentary on Dhp.; Fausb. refers to Fausböllʼs ed. of Dhp.
Dhp. c.	Dhammapada (Pali); Dhp. c(omm.), commentary on Dhp.; Fausb. refers to Fausböllʼs ed. of Dhp.
Dhp. comm.	Dhammapada (Pali); Dhp. c(omm.), commentary on Dhp.; Fausb. refers to Fausböllʼs ed. of Dhp.
Dhs	Dhammasaṃgani (Pali).
Dhs.	Dhammasaṃgani (Pali).
Dhs. transl.	Dhammasaṃgani (Pali).
Dhātup.	Dhātupāṭha.
Di	?
Dict. Cath. Miss.	the Tibetan Dictionary of the French Catholic Mission.
Dict. Fr. Cath. Miss.	the Tibetan Dictionary of the French Catholic Mission.
Dict. of French Cath. Miss.	the Tibetan Dictionary of the French Catholic Mission.
Dict. of the Fr. Cath. Miss.	the Tibetan Dictionary of the French Catholic Mission.
Divy	Divyāvadāna, ed. Cowell and Neil, Cambridge, 1886.
Divy Index	Divyāvadāna, ed. Cowell and Neil, Cambridge, 1886.
Divy, Index	Divyāvadāna, ed. Cowell and Neil, Cambridge, 1886.
Divy.	Divyāvadāna, ed. Cowell and Neil, Cambridge, 1886.
Divy., Index	Divyāvadāna, ed. Cowell and Neil, Cambridge, 1886.
DN	Dīghanikāya (Pali).
DN comm.	Dīghanikāya (Pali).
Dnp.	?
DPPN	Malalasekara, Dictionary of Pali Proper Names.
Dpv.	Dīp.
Dpvs.	Dīp.
Dr. Paul Tedesco	?
Dutoitʼs transl.	?
Dutreuil	?
Dutreuil ‘Prakrit Dhammapada’	?
Dutreuil, C fragm.	?
Dutt	Mūla-Sarvāstivāda-Vinaya; Gilgit Manuscripts, ed. Nalinaksha Dutt, Vol. 3, Parts i (undated), ii (1942), iii (1943), Srinagar, Kashmir. Part iv (1950) arrived late, but its most important words have been included. Unfortunately this valuable series came to hand so late in the progress of my task that I felt it impossible to include Volumes 1 and 2, which seem somewhat less important.
Dutt Introd.	Mūla-Sarvāstivāda-Vinaya; Gilgit Manuscripts, ed. Nalinaksha Dutt, Vol. 3, Parts i (undated), ii (1942), iii (1943), Srinagar, Kashmir. Part iv (1950) arrived late, but its most important words have been included. Unfortunately this valuable series came to hand so late in the progress of my task that I felt it impossible to include Volumes 1 and 2, which seem somewhat less important.
Dhvajāgrasūtra, Waldschmidt, Kl. Skt. Texte 4	?
Dvy	?
Dāṭh.	?
Dīp.	Dīpavaṃsa (Pali).
Dīpav.	?
E. Lamotte, LʼĀlayavijñāna [Le Réceptacle] dans le Mahāyāna-saṃgraha, Mél. chin. et boud., vol. 3, Brussels, 1935	?
Edgerton, Festschrift Winternitz	?
Edgerton, Indian Studies in honor of C.R. Lanman	?
Edgerton, JAOS	?
Edgerton, Mīmāṃsā Nyāya Prakāśa, Gloss. Ind.	?
Eggelingʼs transl.	?
Etymolog. gloss Śikṣ	?
EV	?
F.	?
F.W.K. Müller, Ethnologisches, Notizblatt	?
F.ʼs ed.	?
Fausböll	?
Fausböll Dhp. comm.	?
Feer	Avadāna-śataka, ed. Speyer, 2 vols., St. Petersburg, 1902, 1906; transl. Feer, Annales du Musée Guimet 18 (1891).
Feer on Av	Avadāna-śataka, ed. Speyer, 2 vols., St. Petersburg, 1902, 1906; transl. Feer, Annales du Musée Guimet 18 (1891).
Feer, Av transl.	Avadāna-śataka, ed. Speyer, 2 vols., St. Petersburg, 1902, 1906; transl. Feer, Annales du Musée Guimet 18 (1891).
Feer, Transl. of Av	Avadāna-śataka, ed. Speyer, 2 vols., St. Petersburg, 1902, 1906; transl. Feer, Annales du Musée Guimet 18 (1891).
Finot	?
Finot on Prāt	?
Finot, Lap. ind.	?
Finot, Lapidaires indiens	?
Finot, Prāt	?
Finotʼs report of Chin. on Prāt	?
Foucaux	see LV. Lalitavistara, ed. Lefmann, Halle, 1902
Foucaux, Notes	Lalitavistara, ed. Lefmann, Halle, 1902; Critical Apparatus, 1908; abbreviated Lefm.; ‘Calc.’ = ed. of Rajendralala Mitra, Calcutta, 1877; transl. Foucaux, Annales du Musée Guimet 6, and Notes, 19; Tibetan version (partial), with transl., by Foucaux, Paris, 1847; Weller = F. Weller, Zum Lalita Vistara, I. Über die Prosa des Lal. Vist., Leipzig, 1915.
Foucauxʼs note	Lalitavistara, ed. Lefmann, Halle, 1902; Critical Apparatus, 1908; abbreviated Lefm.; ‘Calc.’ = ed. of Rajendralala Mitra, Calcutta, 1877; transl. Foucaux, Annales du Musée Guimet 6, and Notes, 19; Tibetan version (partial), with transl., by Foucaux, Paris, 1847; Weller = F. Weller, Zum Lalita Vistara, I. Über die Prosa des Lal. Vist., Leipzig, 1915.
Foucauxʼs transl.	Lalitavistara, ed. Lefmann, Halle, 1902; Critical Apparatus, 1908; abbreviated Lefm.; ‘Calc.’ = ed. of Rajendralala Mitra, Calcutta, 1877; transl. Foucaux, Annales du Musée Guimet 6, and Notes, 19; Tibetan version (partial), with transl., by Foucaux, Paris, 1847; Weller = F. Weller, Zum Lalita Vistara, I. Über die Prosa des Lal. Vist., Leipzig, 1915.
Foucauxʼs Transl.	Lalitavistara, ed. Lefmann, Halle, 1902; Critical Apparatus, 1908; abbreviated Lefm.; ‘Calc.’ = ed. of Rajendralala Mitra, Calcutta, 1877; transl. Foucaux, Annales du Musée Guimet 6, and Notes, 19; Tibetan version (partial), with transl., by Foucaux, Paris, 1847; Weller = F. Weller, Zum Lalita Vistara, I. Über die Prosa des Lal. Vist., Leipzig, 1915.
Foucauxʼs ed.	?
fragm. 23 V 2	?
fragment 36 V 3	?
fragment 44 V 1	?
Francis and Dutoit	?
French Catholic Dict.	the Tibetan Dictionary of the French Catholic Mission.
G.W. Brown, JAOS	?
Galanos	?
Garbe, Ind. Min.	?
Gauthiot, MSL 19 (1915)	Mémoires de la Société de Linguistique (de Paris).
Gaṇapati Sastri	?
Gaṅgamāla Jāt.	?
Gaṅgamāla-Jāt.	?
Geiger	Pali, Strassburg, 1916. Cited by numbers of sections, without the symbol §.
Geigerʼs Index	Pali, Strassburg, 1916. Cited by numbers of sections, without the symbol §.
Gobh.GS.	Gobhila Gṛhya Sūtra.
GobhGS.	Gobhila Gṛhya Sūtra.
GOS	Gaekwadʼs Oriental Series.
Gray, ZDMG	Gray in Zeitschrift der deutschen morgenländischen Gesellschaft.
Guhyasamāja	ed. Bhattacharya, Gaekwadʼs Oriental Series 53, Baroda, 1931; contains a few verses with BHS forms; very rarely cited.
Gv	Gaṇḍavyūha, ed. Suzuki and Idzumi, Kyoto, 1934—36; 2d ed., photographically reproduced with corrections, 1949.
H. Smith	?
H.M. Johnson, Triṣaṣṭiśalākāpuruṣacaritra I	?
Haravijaya	?
Hardy ap. Childers	?
Hardy, Album Kern	?
Hardy, AN	?
Hardyʼs Eastern Monachism	?
Hariv.	Harivaṃśa
Harṣac.	Harṣacarita
Hem.	Hemacandra, chiefly his Prakrit Grammar, ed. and transl. Pischel, Halle, 1877, 1880; see also Deśīn.
Hem. Abhidh.	Abhidhānacintāmaṇi by Hemacandra
Hem. Pariś.	Pariśiṣṭa by Hemacandra
Hem. Pkt. Gr.	Prakrit grammar by Hemacandra
Hem. Yogaś.	Yogaśāstra by Hemacandra
Hemacandra, Gr.	Sanskrit grammar by Hemacandra
Hertel, ZDMG	Hertel in Zeitschrift der deutschen morgenländischen Gesellschaft.
Hindī Śabdasāgara (1914), 1	?
Hoernle	see MR. Hoernle (general editor), Manuscript Remains of Buddhist literature found in Eastern Turkestan, Oxford, 1916. BHS fragments ed. by Hoernle, Lüders, Pargiter, Thomas.
Hoernle MR	see MR. Hoernle (general editor), Manuscript Remains of Buddhist literature found in Eastern Turkestan, Oxford, 1916. BHS fragments ed. by Hoernle, Lüders, Pargiter, Thomas.
Hoernle, JRAS	MR Hoernle in Journal of the Royal Asiatic Society.
Hoernle, JRAS 1916	MR Hoernle in Journal of the Royal Asiatic Society.
Hoernle, MR	see MR. Hoernle (general editor), Manuscript Remains of Buddhist literature found in Eastern Turkestan, Oxford, 1916. BHS fragments ed. by Hoernle, Lüders, Pargiter, Thomas.
Hoernleʼs terminology	see MR. Hoernle (general editor), Manuscript Remains of Buddhist literature found in Eastern Turkestan, Oxford, 1916. BHS fragments ed. by Hoernle, Lüders, Pargiter, Thomas.
Hoffmann, Kl. Skt. Texte 5	?
HOS	Harvard Oriental Series.
Hultzsch	Inscr(iptions) of Asoka, Oxford, 1925.
Hultzsch, Aśoka	Inscr(iptions) of Asoka, Oxford, 1925.
Hultzsch, Inscr. Aśoka	Inscr(iptions) of Asoka, Oxford, 1925.
Hāla (Weber)	?
I. St.	Indische Studien (Weber).
IHQ	Indian Historical Quarterly.
Ind. Spr.	Boehtlingk, Indische Sprüche (2d ed.).
Ind. Spr.²	Boehtlingk, Indische Sprüche (2d ed.).
Ind. St.	Indische Studien (Weber).
Ind. Stud.	Indische Studien (Weber).
Index	?
Index to Av, KSS	?
Index to Bbh	?
Index to Divy	?
Index to KN	?
Index to Laṅk	?
Index to Lefm.	?
Index to Mironov	?
Index to Mvy	?
ISt.	?
It.	Itivuttaka (Pali).
Itiv.	Itivuttaka (Pali).
J. Bloch, Fest. Wackernagel	?
J.J. Meyer, Index	?
Jacobi	?
Jacobi, Ausgew. Erz.	Ausgewählte Erzählungen in Māhārāṣṭrī. See also Bhav., San.
Jacobi, Bhav.	Bhavisattakahā (Ap.), ed. Jacobi (1918).
Jacobi, Bhav. Gloss.	Bhavisattakahā (Ap.), ed. Jacobi (1918). Glossary
Jacobi, Bhav., Glossar	Bhavisattakahā (Ap.), ed. Jacobi (1918). Glossary
Jacobi, Bhav., Index	Bhavisattakahā (Ap.), ed. Jacobi (1918). Index
Jacobi, Erz.	?
Jacobi, San.	Sanatkumāracaritam (Ap.), ed. Jacobi (1921).
Jacobi, SBE 45	?
JAOS	Journal of the American Oriental Society.
Jaugada Sep.	?
JB, Whitney, JAOS	?
Jm	Jātakamālā, ed. Kern (HOS 1), Boston, 1891. Its language is close to standard Skt., but contains quite a number of BHS words, and even a few forms; see § 1.53, fn. 17. Transl. Speyer, London, 1895.
Jm (App.)	?
Johnston	?
Johnston on Saund.	Saundarānanda, ed. Johnston.
Johnston, note on Buddhac.	Buddhacarita, ed. Johnston, Calcutta, 1935. The language is standard Skt.; a few words, chiefly religious, are cited by chapter and verse.
Johnston, notes on Saundarān.	Saundarānanda, ed. Johnston.
Johnston, Saundarān.	Saundarānanda, ed. Johnston.
Johnstonʼs note	Buddhacarita, ed. Johnston, Calcutta, 1935. The language is standard Skt.; a few words, chiefly religious, are cited by chapter and verse.
JRAS Oct. 1875 (N.S. VIII Pt. 1)	Journal of the Royal Asiatic Society.
Julienʼs ‘Hiouen-Thsang’	?
Jä	see Jäschke. Jäschke, Tibetan-English Dictionary.
Jä.	see Jäschke. Jäschke, Tibetan-English Dictionary.
Jäschke	Jäschke, Tibetan-English Dictionary.
Jäschkeʼs Grammar	?
Jāt	Jātaka (Pali).
Jāt.	Jātaka (Pali).
Jāt. comm.	Jātaka (Pali).
K.	?
K.P.	?
Kalpadrumāv.	?
Kalpanā-maṇḍitikā (Lüders, Kl. Skt. Texte 2) 44 V 1	?
Kalpanām.	?
Kalpanāmaṇḍitikā	?
Kalpanāmaṇḍitikā 114 V 2	?
Kalpanāmaṇḍitikā 196.V.2	?
Kalpanāmaṇḍitikā, Kl. Skt. Texte 2	?
Kalpanāmaṇḍitikā, Lüders, Kl. Skt. Texte 2	?
Karmav	(Mahā-)Karmavibhaṅga, and Karmavibhaṅgopadesa, ed. Lévi, Paris, 1932.
Karmav.	?
Kashgar fragment	‘Kashgar’ or Central Asiatic recension
Kashgar fragments	‘Kashgar’ or Central Asiatic recension
Kashgar rec.	‘Kashgar’ or Central Asiatic recension
Kashgar version	‘Kashgar’ or Central Asiatic recension
Kathās.	Kathāsaritsāgara.
Kauś.	Kauśika Sūtra.
Kauṣ Up.	?
Kauṣ. Up.	?
Kauṭ.	Kauṭiliya (Arthaśāstra).
Kauṭ. A.	Kauṭiliya (Arthaśāstra).
Kauṭ. Arth.	Kauṭiliya (Arthaśāstra).
Kauṭ. Arth. Sham.	Kauṭiliya (Arthaśāstra).
Kauṭ. Arth. Sham.¹	Kauṭiliya (Arthaśāstra).
Kauṭ. Arth., Sham.¹	Kauṭiliya (Arthaśāstra).
Kauṭ. Arth., Shama-S.¹	Kauṭiliya (Arthaśāstra).
Kauṭ. Shama Sastri 1st ed.	Kauṭiliya (Arthaśāstra).
KaṭhaU.	?
KBr.	?
Keith	?
Kenop.	?
Kern	?
Kern (Transl.)	?
Kern SBE	?
Kern SP Preface	?
Kern, Der Buddhismus	?
Kern, IF.	?
Kern, note to Transl., SBE	?
Kern, Preface	?
Kern, SBE	?
Kern, SBE 21	?
Kern, SP	?
Kern, SP Preface	?
Kern, Transl.	?
Kern, Versl. K. Akad. Afd. Lett.	?
Kernʼs ed.	?
Kernʼs note in Transl. of SP, SBE 21	Saddharmapuṇḍarīka, ed. Kern and Nanjio, St. Petersburg, 1912, abbreviated KN; supplementary references to ed. of Wogihara and Tsuchida, Tokyo, 1934—35, abbreviated WT; fragments of ‘Kashgar’ or Central Asiatic recension, ed. Thomas and Lüders, ap. Hoernle, MR 133 ff., 144 ff.; others, ed. LaVallée Poussin, JRAS 1911, 1070 ff.; transl. Burnouf (Lotus de la Bonne Loi, Paris, 1852), and Kern (SBE 21, Oxford, 1884). Tibetan citations chiefly from block-print in my possession, partly from WT. When my work was practically ready for print, my colleague Professor Rahder received, and lent to me, the photostatic reproduction of the ms. referred to by WT as Ḱ. It has been cited a very few times. The quotations from it in WT seem to be very inaccurate.
Kernʼs Preface	Saddharmapuṇḍarīka, ed. Kern and Nanjio, St. Petersburg, 1912, abbreviated KN; supplementary references to ed. of Wogihara and Tsuchida, Tokyo, 1934—35, abbreviated WT; fragments of ‘Kashgar’ or Central Asiatic recension, ed. Thomas and Lüders, ap. Hoernle, MR 133 ff., 144 ff.; others, ed. LaVallée Poussin, JRAS 1911, 1070 ff.; transl. Burnouf (Lotus de la Bonne Loi, Paris, 1852), and Kern (SBE 21, Oxford, 1884). Tibetan citations chiefly from block-print in my possession, partly from WT. When my work was practically ready for print, my colleague Professor Rahder received, and lent to me, the photostatic reproduction of the ms. referred to by WT as Ḱ. It has been cited a very few times. The quotations from it in WT seem to be very inaccurate.
Kernʼs SP Preface	Saddharmapuṇḍarīka, ed. Kern and Nanjio, St. Petersburg, 1912, abbreviated KN; supplementary references to ed. of Wogihara and Tsuchida, Tokyo, 1934—35, abbreviated WT; fragments of ‘Kashgar’ or Central Asiatic recension, ed. Thomas and Lüders, ap. Hoernle, MR 133 ff., 144 ff.; others, ed. LaVallée Poussin, JRAS 1911, 1070 ff.; transl. Burnouf (Lotus de la Bonne Loi, Paris, 1852), and Kern (SBE 21, Oxford, 1884). Tibetan citations chiefly from block-print in my possession, partly from WT. When my work was practically ready for print, my colleague Professor Rahder received, and lent to me, the photostatic reproduction of the ms. referred to by WT as Ḱ. It has been cited a very few times. The quotations from it in WT seem to be very inaccurate.
Kernʼs SP preface	Saddharmapuṇḍarīka, ed. Kern and Nanjio, St. Petersburg, 1912, abbreviated KN; supplementary references to ed. of Wogihara and Tsuchida, Tokyo, 1934—35, abbreviated WT; fragments of ‘Kashgar’ or Central Asiatic recension, ed. Thomas and Lüders, ap. Hoernle, MR 133 ff., 144 ff.; others, ed. LaVallée Poussin, JRAS 1911, 1070 ff.; transl. Burnouf (Lotus de la Bonne Loi, Paris, 1852), and Kern (SBE 21, Oxford, 1884). Tibetan citations chiefly from block-print in my possession, partly from WT. When my work was practically ready for print, my colleague Professor Rahder received, and lent to me, the photostatic reproduction of the ms. referred to by WT as Ḱ. It has been cited a very few times. The quotations from it in WT seem to be very inaccurate.
Kernʼs Transl.	?
Kernʼs transl.	?
Kernʼs Transl. SBE	?
Khantivādi Jāt.	?
Khp.	?
KhP.	?
Khp. comm.	?
Khud.p.	?
Khud.p. comm.	?
Kir.	?
Kirfel	Kosmographie der Inder.
Kirfel, Kosm.	Kosmographie der Inder.
Kirfel, Kosm., Index	Kosmographie der Inder.
Kirfel, Kosmographie	Kosmographie der Inder.
Kl. Skt. Texte 2	?
Kleinere Skt. Texte II	?
Knauer	?
KN	(see SP) Saddharmapuṇḍarīka, ed. Kern and Nanjio, St. Petersburg, 1912
KN Preface	?
KN, Index	?
Kondoʼs ed.	?
Konow	?
Konow MASI 69	?
Konow, Avhandl. Norske Viden. Akad. 1941, II. Hist.-Fil. Kl.	?
Konow, Saka versions of the Bhadrakalpikā-(sic)-sūtra, Oslo Akad. hist.-fil. kl. 1929	?
Koṇḍañña Jāt.	?
Kosegartenʼs Pañcatantra	?
KP	Kāśyapa Parivarta, ed. Staël-Holstein, Shanghai, 1926. Cited by sections as numbered in edition, and lines.
KSS	Kathāsaritsāgara.
KSS.	?
Kull. on Manu	?
Kunst, BSOS	Bulletin of the School of Oriental (and African) Studies, London.
Kusa Jāt.	?
KV	Kāraṇḍavyūha, in The Hindu Commentator, vol. 5; 1872.
Kv	Kāraṇḍavyūha, in The Hindu Commentator, vol. 5; 1872.
Kvu	Kathā-vatthu (Pali).
Kvu. transl.	Kathā-vatthu (Pali).
Kād.	?
Kār.	?
Kāty. Dharmaś.	?
Kātyāyanāvavāda MPS	?
KātyŚrS	?
Kāś.	Kāśikā (comm. on Pāṇ.).
Kāṇva	?
KŚS	Kātyāyana Śrauta Sūtra.
Kṣānti-Jāt.	?
Lalou	Iconographie (des étoffes peintes dans le Mañjuśrīmūlakalpa), Paris, 1930.
Lalou Iconographie	?
Lalou, Iconographie	?
Lang.	Language (Journal of the Linguistic Society of America).
Lassen IA.	?
LaV-P	?
LaV-P in JRAS	LaVallée Poussin in Journal of the Royal Asiatic Society.
LaV-P, AbhidhK.	Abhidharmakośa, transl. LaVallée Poussin, Paris and Louvain, 1923—31; many technical words cited from Index, transl., and notes. References, as in the Index, are to Book (of the original) and page of the translation.
LaV-P.	LaVallée Poussin
LaV-P. AbhidhK.	Abhidharmakośa, transl. LaVallée Poussin, Paris and Louvain, 1923—31; many technical words cited from Index, transl., and notes. References, as in the Index, are to Book (of the original) and page of the translation.
LaV-P. AbhidhK. Index	Abhidharmakośa, transl. LaVallée Poussin, Paris and Louvain, 1923—31; many technical words cited from Index, transl., and notes. References, as in the Index, are to Book (of the original) and page of the translation.
LaV-P. Index	Abhidharmakośa, transl. LaVallée Poussin, Paris and Louvain, 1923—31; many technical words cited from Index, transl., and notes. References, as in the Index, are to Book (of the original) and page of the translation.
LaV-P. JRAS	LaVallée Poussin in Journal of the Royal Asiatic Society.
LaV-P., AbhidhK.	Abhidharmakośa, transl. LaVallée Poussin, Paris and Louvain, 1923—31; many technical words cited from Index, transl., and notes. References, as in the Index, are to Book (of the original) and page of the translation.
LaV-P., Index	Abhidharmakośa, transl. LaVallée Poussin, Paris and Louvain, 1923—31; many technical words cited from Index, transl., and notes. References, as in the Index, are to Book (of the original) and page of the translation.
LaV-P.ʼs note	Abhidharmakośa, transl. LaVallée Poussin, Paris and Louvain, 1923—31; many technical words cited from Index, transl., and notes. References, as in the Index, are to Book (of the original) and page of the translation.
LaV-Pʼs Index	Abhidharmakośa, transl. LaVallée Poussin, Paris and Louvain, 1923—31; many technical words cited from Index, transl., and notes. References, as in the Index, are to Book (of the original) and page of the translation.
LaVallée Poussin	?
LaVallée Poussin JRAS	LaVallée Poussin in Journal of the Royal Asiatic Society.
LaVallée Poussin JRAS 1911	LaVallée Poussin in Journal of the Royal Asiatic Society.
LaVallée Poussin JRAS 1913	LaVallée Poussin in Journal of the Royal Asiatic Society.
LaVallée Poussin JRAS 1913 (Stein fragments)	?
LaVallée Poussin vol. 4	?
LaVallée Poussin, AbhidhK	Abhidharmakośa, transl. LaVallée Poussin, Paris and Louvain, 1923—31; many technical words cited from Index, transl., and notes. References, as in the Index, are to Book (of the original) and page of the translation.
LaVallée Poussin, AbhidhK.	Abhidharmakośa, transl. LaVallée Poussin, Paris and Louvain, 1923—31; many technical words cited from Index, transl., and notes. References, as in the Index, are to Book (of the original) and page of the translation.
LaVallée Poussin, HJAS	LaVallée Poussin in Harvard Journal of Asiatic Studies.
LaVallée Poussin, JRAS	LaVallée Poussin in Journal of the Royal Asiatic Society.
LaVallée Poussin, JRAS 1913	LaVallée Poussin in Journal of the Royal Asiatic Society.
LaVallée Poussin, note on MadhK	?
LaVallée Poussin, trnsl. of AbhidhK.	Abhidharmakośa, transl. LaVallée Poussin, Paris and Louvain, 1923—31; many technical words cited from Index, transl., and notes. References, as in the Index, are to Book (of the original) and page of the translation.
LaVallée Poussinʼs Index	Abhidharmakośa, transl. LaVallée Poussin, Paris and Louvain, 1923—31; many technical words cited from Index, transl., and notes. References, as in the Index, are to Book (of the original) and page of the translation.
LaVallée- Poussin, AbhidhK.	Abhidharmakośa, transl. LaVallée Poussin, Paris and Louvain, 1923—31; many technical words cited from Index, transl., and notes. References, as in the Index, are to Book (of the original) and page of the translation.
LaVallée-Poussin	?
LaVallée-Poussin JRAS	LaVallée Poussin in Journal of the Royal Asiatic Society.
LaVallée-Poussin, AbhidhK	Abhidharmakośa, transl. LaVallée Poussin, Paris and Louvain, 1923—31; many technical words cited from Index, transl., and notes. References, as in the Index, are to Book (of the original) and page of the translation.
LaVallée-Poussin, AbhidhK.	Abhidharmakośa, transl. LaVallée Poussin, Paris and Louvain, 1923—31; many technical words cited from Index, transl., and notes. References, as in the Index, are to Book (of the original) and page of the translation.
LaVallée-Poussin, Bodhicaryāvatārapañjikā	?
LaVallée-Poussin, HJAS	LaVallée Poussin in Harvard Journal of Asiatic Studies.
LaVallée-Poussin, JRAS	LaVallée Poussin in Journal of the Royal Asiatic Society.
LaVallée-Poussin, JRAS 1911	LaVallée Poussin in Journal of the Royal Asiatic Society.
LaVallée-Poussinʼs Transl.	Abhidharmakośa, transl. LaVallée Poussin, Paris and Louvain, 1923—31; many technical words cited from Index, transl., and notes. References, as in the Index, are to Book (of the original) and page of the translation.
LaVallée-Poussinʼs version, JRAS	LaVallée Poussin in Journal of the Royal Asiatic Society.
Laṅk	Laṅkāvatāra-sūtra, ed. Nanjio, Kyoto, 1923; transl. Suzuki, London, 1932; Index, by Suzuki, Kyoto, 1934; ‘Studies’ = Suzuki, Studies in the Lankavatara Sutra, London, 1930.
Laṅk.	?
Ledi Sadaw JPTS	Ledi Sadaw in Journal of the Pali Text Society.
Lefm	?
Lefm.	see LV. Lalitavistara, ed. Lefmann, Halle, 1902see LV.
Lefm.ʼs Index	?
Lefmann	?
Lefmannʼs ed.	?
Leumann	?
Leumann, Album Kern	?
Leumann, Aup.S.	?
Leumann, Das nordarische Lehrgedicht des Buddhismus, AKM	?
Leumannʼs etym., ap. Wogihara, Lex. aus der Bbh.	?
Lib. of Congr. ed.	Library of Congress edition
Lin Li-Kouang. Aide-Mémoire	?
Loiseleur	?
Lotus	Lotus de la Bonne Loi, Paris, 1852
Ludwig RV	?
LV	Lalitavistara, ed. Lefmann, Halle, 1902; Critical Apparatus, 1908; abbreviated Lefm.; ‘Calc.’ = ed. of Rajendralala Mitra, Calcutta, 1877; transl. Foucaux, Annales du Musée Guimet 6, and Notes, 19; Tibetan version (partial), with transl., by Foucaux, Paris, 1847; Weller = F. Weller, Zum Lalita Vistara, I. Über die Prosa des Lal. Vist., Leipzig, 1915.
Lv	Lalitavistara, ed. Lefmann, Halle, 1902; Critical Apparatus, 1908; abbreviated Lefm.; ‘Calc.’ = ed. of Rajendralala Mitra, Calcutta, 1877; transl. Foucaux, Annales du Musée Guimet 6, and Notes, 19; Tibetan version (partial), with transl., by Foucaux, Paris, 1847; Weller = F. Weller, Zum Lalita Vistara, I. Über die Prosa des Lal. Vist., Leipzig, 1915.
LV (Calc.)	Lalitavistara, ed. Lefmann, Halle, 1902; Critical Apparatus, 1908; abbreviated Lefm.; ‘Calc.’ = ed. of Rajendralala Mitra, Calcutta, 1877; transl. Foucaux, Annales du Musée Guimet 6, and Notes, 19; Tibetan version (partial), with transl., by Foucaux, Paris, 1847; Weller = F. Weller, Zum Lalita Vistara, I. Über die Prosa des Lal. Vist., Leipzig, 1915.
LV (Lefm.)	?
LVa	?
LVb	?
Lévi	Mahā-Māyūrī. Two figures refer to page and line of ed. by Oldenbourg in Zapiski Vostochnago Otdelenija Imp. Russk. Archeol. Obschestva, Tom 11 (1899), 218—261. A single number refers to the numbered lines of ‘Le catalogue géographique des yakṣa dans la Mahā-Māyūrī’, by S. Lévi, JAs. XI. 5 (1915), pp. 1—138.
Lévi (Sūtrāl.)	Asaṅga, Mahāyāna-sūtrālaṃkāra, ed. and transl. Lévi, Bibliothèque de lʼÉcole des Hautes Études, 159 and 190, Paris, 1907, 1911. The language is standard Skt., but the text and Léviʼs notes are important for the understanding of many technical terms. Cited by chapter and verse (with commentary after each verse).
Lévi BEFEO.	?
Lévi JA 1912, Pt. 2	Journal Asiatique.
Lévi JA. 1912 Pt. 2	Journal Asiatique.
Lévi Māy	Mahā-Māyūrī. Two figures refer to page and line of ed. by Oldenbourg in Zapiski Vostochnago Otdelenija Imp. Russk. Archeol. Obschestva, Tom 11 (1899), 218—261. A single number refers to the numbered lines of ‘Le catalogue géographique des yakṣa dans la Mahā-Māyūrī’, by S. Lévi, JAs. XI. 5 (1915), pp. 1—138.
Lévi note	Asaṅga, Mahāyāna-sūtrālaṃkāra, ed. and transl. Lévi, Bibliothèque de lʼÉcole des Hautes Études, 159 and 190, Paris, 1907, 1911. The language is standard Skt., but the text and Léviʼs notes are important for the understanding of many technical terms. Cited by chapter and verse (with commentary after each verse).
Lévi on Sūtrāl.	Asaṅga, Mahāyāna-sūtrālaṃkāra, ed. and transl. Lévi, Bibliothèque de lʼÉcole des Hautes Études, 159 and 190, Paris, 1907, 1911. The language is standard Skt., but the text and Léviʼs notes are important for the understanding of many technical terms. Cited by chapter and verse (with commentary after each verse).
Lévi Sūtrāl.	Asaṅga, Mahāyāna-sūtrālaṃkāra, ed. and transl. Lévi, Bibliothèque de lʼÉcole des Hautes Études, 159 and 190, Paris, 1907, 1911. The language is standard Skt., but the text and Léviʼs notes are important for the understanding of many technical terms. Cited by chapter and verse (with commentary after each verse).
Lévi Transl.	Asaṅga, Mahāyāna-sūtrālaṃkāra, ed. and transl. Lévi, Bibliothèque de lʼÉcole des Hautes Études, 159 and 190, Paris, 1907, 1911. The language is standard Skt., but the text and Léviʼs notes are important for the understanding of many technical terms. Cited by chapter and verse (with commentary after each verse).
Lévi, JA 1912 (vol. 20)	Journal Asiatique.
Lévi, JA 1915	Journal Asiatique.
Lévi, JA Nov.—Dec. 1912	Journal Asiatique.
Lévi, JA. Nov.—Dec. 1912	Journal Asiatique.
Lévi, JAs. 1915, I	Journal Asiatique.
Lévi, Karmav	?
Lévi, Māy	Mahā-Māyūrī. Two figures refer to page and line of ed. by Oldenbourg in Zapiski Vostochnago Otdelenija Imp. Russk. Archeol. Obschestva, Tom 11 (1899), 218—261. A single number refers to the numbered lines of ‘Le catalogue géographique des yakṣa dans la Mahā-Māyūrī’, by S. Lévi, JAs. XI. 5 (1915), pp. 1—138.
Lévi, note to Transl.	Asaṅga, Mahāyāna-sūtrālaṃkāra, ed. and transl. Lévi, Bibliothèque de lʼÉcole des Hautes Études, 159 and 190, Paris, 1907, 1911. The language is standard Skt., but the text and Léviʼs notes are important for the understanding of many technical terms. Cited by chapter and verse (with commentary after each verse).
Lévi, Sūtrāl.	Asaṅga, Mahāyāna-sūtrālaṃkāra, ed. and transl. Lévi, Bibliothèque de lʼÉcole des Hautes Études, 159 and 190, Paris, 1907, 1911. The language is standard Skt., but the text and Léviʼs notes are important for the understanding of many technical terms. Cited by chapter and verse (with commentary after each verse).
Lévi, Sūtrāl. Transl.	Asaṅga, Mahāyāna-sūtrālaṃkāra, ed. and transl. Lévi, Bibliothèque de lʼÉcole des Hautes Études, 159 and 190, Paris, 1907, 1911. The language is standard Skt., but the text and Léviʼs notes are important for the understanding of many technical terms. Cited by chapter and verse (with commentary after each verse).
Léviʼs note	Asaṅga, Mahāyāna-sūtrālaṃkāra, ed. and transl. Lévi, Bibliothèque de lʼÉcole des Hautes Études, 159 and 190, Paris, 1907, 1911. The language is standard Skt., but the text and Léviʼs notes are important for the understanding of many technical terms. Cited by chapter and verse (with commentary after each verse).
Léviʼs note in Transl.	Asaṅga, Mahāyāna-sūtrālaṃkāra, ed. and transl. Lévi, Bibliothèque de lʼÉcole des Hautes Études, 159 and 190, Paris, 1907, 1911. The language is standard Skt., but the text and Léviʼs notes are important for the understanding of many technical terms. Cited by chapter and verse (with commentary after each verse).
Léviʼs notes	Asaṅga, Mahāyāna-sūtrālaṃkāra, ed. and transl. Lévi, Bibliothèque de lʼÉcole des Hautes Études, 159 and 190, Paris, 1907, 1911. The language is standard Skt., but the text and Léviʼs notes are important for the understanding of many technical terms. Cited by chapter and verse (with commentary after each verse).
Léviʼs transl.	Asaṅga, Mahāyāna-sūtrālaṃkāra, ed. and transl. Lévi, Bibliothèque de lʼÉcole des Hautes Études, 159 and 190, Paris, 1907, 1911. The language is standard Skt., but the text and Léviʼs notes are important for the understanding of many technical terms. Cited by chapter and verse (with commentary after each verse).
Léviʼs Transl.	Asaṅga, Mahāyāna-sūtrālaṃkāra, ed. and transl. Lévi, Bibliothèque de lʼÉcole des Hautes Études, 159 and 190, Paris, 1907, 1911. The language is standard Skt., but the text and Léviʼs notes are important for the understanding of many technical terms. Cited by chapter and verse (with commentary after each verse).
Lüders	?
Lüders ap. Hoernle MR	?
Lüders SBAW	?
Lüders, KI. Skt. Texte	?
Lüders, Kl. Skt. Texte 2	?
Lüders, KZ	?
Lüders, SBAW	?
Lüdersʼ discussion	?
Lāṭy.	Lāṭyāyana Śrauta Sūtra.
LāṭyŚS.	?
M. Leumann, IF	?
M. Müller on Dharmas	?
MadhK	Mūla-Madhyamaka-kārikās, with comm., ed. LaVallée Poussin, St. Petersburg, 1903—1910. Only partially excerpted.
Madhy.	?
Mahā-Dhammapāla Jāt.	?
Mahāparinibbāna-sutta, DN sūtra	?
Mahāsamāj, Waldschmidt, Kl. Skt. Texte 4	Mahāsamājasūtra, in Waldschmidt, Kl. Skt. Texte 4.
Mahāsamaj., Waldschmidt, Kl. Skt. Texte 4	Mahāsamājasūtra, in Waldschmidt, Kl. Skt. Texte 4.
Mahāsamāj.	Mahāsamājasūtra, in Waldschmidt, Kl. Skt. Texte 4.
Mahāsamāj	Mahāsamājasūtra, in Waldschmidt, Kl. Skt. Texte 4.
Mahāsamāj. Kl. Skt. Texte 4	Mahāsamājasūtra, in Waldschmidt, Kl. Skt. Texte 4.
Mahāsamāj. Waldschmidt, Kl. Skt. Texte 4	Mahāsamājasūtra, in Waldschmidt, Kl. Skt. Texte 4.
Mahāsamāj., Waldschmidt, Kl. Skt. Texte 4	Mahāsamājasūtra, in Waldschmidt, Kl. Skt. Texte 4.
Mahāsamājasūtra, Waldschmidt, Kl. Skt. Texte 4	?
Mahāsamayasutta, DN	?
Mahāummagga-j.	?
Mahāv.	Mahāvaṃsa (Pali).
Mahāvaṃsa	?
Manu	?
Max Müller	?
May	?
Mbh	Mahābhārata.
Mbh.	Mahābhārata.
Megh	Meghasūtra, ed. Bendall, JRAS 1880, 288 ff.
Meyer	J. J. Meyerʼs translation of Kauṭ., Leipzig, 1926.
Meyer, Kauṭ.	J. J. Meyerʼs translation of Kauṭ., Leipzig, 1926.
Meyer, Kauṭ. Arth.	J. J. Meyerʼs translation of Kauṭ., Leipzig, 1926.
Meyerʼs Index	J. J. Meyerʼs translation of Kauṭ., Leipzig, 1926.
Meyerʼs transl.	J. J. Meyerʼs translation of Kauṭ., Leipzig, 1926.
Miln.	Milindapañha (Pali).
Milp.	Milindapañha (Pali).
Minayeff	?
Minayeffʼs Prātimokṣa S.	?
Minayev	?
Mir.	?
Mironov	see Mvy. Mahāvyutpatti. Cited by numbered entries in ed. of Sakaki, Kyoto, 1916, with Sanskrit and Tibetan Indexes, 1925 and 1936; some variants are cited from Mironov (2d ed. of Minaeff, which is cited in BR and pw), St. Petersburg, 1910—11. Tibetan version cited from Sakaki; also translations of many Chinese and Japanese renderings ibidem.
Mironov, JRAS	Mironov in Journal of the Royal Asiatic Society.
Mironovʼs ed.	?
Mmk	(Ārya-)Mañjuśrīmūlakalpa, ed. Gaṇapati Śāstri, 3 vols., Trivandrum, 1920, 1922, 1925. See Lalou, in the following list of abbreviations.
Mmk ap. Lalou, Iconographic	?
Mmk; final colophon	?
MN	Majjhimanikāya (Pali).
MN comm.	Majjhimanikāya (Pali).
MN.	Majjhimanikāya (Pali).
Monier Williams	Monier Williams, Sanskrit-English Dictionary (2d ed., 1899).
Monier Williams, Skt. Dict.	Monier Williams, Sanskrit-English Dictionary (2d ed., 1899).
Monier-Williams	Monier Williams, Sanskrit-English Dictionary (2d ed., 1899).
Morris JPTS 1885	Morris in Journal of the Pali Text Society.
MPS	E. Waldschmidt, Das Mahāpariṇirvānasūtra. 3 parts; Abhandlungen der deutschen Akademie…zu Berlin, 1950, 1951. Arrived too late to be extensively used; references are to Waldschmidtʼs numbered divisions.
Mr. D.R.S. Bailey	?
Mrs. Rhys Davids	?
Mrs. Rhys Davids (Minor Anthologies, 1931)	?
Mrs. Rhys Davids, Brethren	?
Mrs. Rhys Davids, Minor Anthologies of the Pali Canon Part IV, 1942	?
Mrs. Rhys Davidsʼ interpretation	?
Mrs. Rhys Davidsʼ transl.	?
MS	Maitrāyaṇī Saṃhitā.
MS.	Maitrāyaṇī Saṃhitā.
MSV	Mūla-Sarvāstivāda-Vinaya; Gilgit Manuscripts, ed. Nalinaksha Dutt, Vol. 3, Parts i (undated), ii (1942), iii (1943), Srinagar, Kashmir. Part iv (1950) arrived late, but its most important words have been included. Unfortunately this valuable series came to hand so late in the progress of my task that I felt it impossible to include Volumes 1 and 2, which seem somewhat less important.
Mus	Barabudur (1935).
Mus, Barabudur (II)	Barabudur (1935).
MV	?
Mv	Mahāvastu, ed. Senart, Paris, 1882, 1890, 1897. The first volume of Jonesʼs translation (London, 1949) appeared, to my regret, too late to be much used (I received it in 1950).
Mv.	?
Mvy	Mahāvyutpatti. Cited by numbered entries in ed. of Sakaki, Kyoto, 1916, with Sanskrit and Tibetan Indexes, 1925 and 1936; some variants are cited from Mironov (2d ed. of Minaeff, which is cited in BR and pw), St. Petersburg, 1910—11. Tibetan version cited from Sakaki; also translations of many Chinese and Japanese renderings ibidem.
MW	Monier Williams, Sanskrit-English Dictionary (2d ed., 1899).
MW.	Monier Williams, Sanskrit-English Dictionary (2d ed., 1899).
Müller	?
Müller on Dharmas	?
Müller on Sukh	?
Müller SBE 49.2	?
Müller, in Transl. of Sukh	?
Müller, note on Dharmas	?
Müller, SBE 49, Part 2	?
Müller, SBE 49.2	?
Müller, transl.	?
Müller, Transl.	?
Müller. SBE 49, 2	?
Müllerʼs ed.	?
Müllerʼs note	?
Müllerʼs Transl.	?
Mādhy.	?
Mān.	?
Mārk. Pur.	Mārkaṇḍeya Purāṇa.
Māti (or Mātu)-posaka Jāt.	?
Māy	Mahā-Māyūrī. Two figures refer to page and line of ed. by Oldenbourg in Zapiski Vostochnago Otdelenija Imp. Russk. Archeol. Obschestva, Tom 11 (1899), 218—261. A single number refers to the numbered lines of ‘Le catalogue géographique des yakṣa dans la Mahā-Māyūrī’, by S. Lévi, JAs. XI. 5 (1915), pp. 1—138.
N. Dutt	?
N. Dutt, Introd.	?
N. Dutt, Introd. to MSV	?
N. Dutt, MSV	?
N. Duttʼs interpretation	?
N. Duttʼs note	?
Nalinaksha Dutt in IHQ 7 (1931)	?
Naḷinikā-jātaka	?
Nanjio	?
Neisser, Z. Wbch.d. RV.	?
Nett.	Nettipakaraṇa (Pali).
NIA.	?
Nimi Jāt.	?
Nir.	Yāskaʼs Nirukta.
Nirukta	Yāskaʼs Nirukta.
Nobel	Suvarṇabhāsottamasūtra, ed. Nobel, Leipzig, 1937; Tibetan version, ed. same, Leiden and Stuttgart, 1944.
Nobel, Introd.	Suvarṇabhāsottamasūtra, ed. Nobel, Leipzig, 1937; Tibetan version, ed. same, Leiden and Stuttgart, 1944.
Nobel, JAOS Supplement 11 to Vol. 71 No. 3, 1951	?
Nobelʼs ed.	?
Nobelʼs note	Suvarṇabhāsottamasūtra, ed. Nobel, Leipzig, 1937; Tibetan version, ed. same, Leiden and Stuttgart, 1944.
Nobelʼs text	Suvarṇabhāsottamasūtra, ed. Nobel, Leipzig, 1937; Tibetan version, ed. same, Leiden and Stuttgart, 1944.
Nyagrodhamṛga Jāt.	?
Nīl.	?
Nīlak.	?
Oldenberg	?
Oldenburg	?
P. Mus	?
P. Mus, Barabudur	?
P. Mus, La Lumière des six voies	?
P.C. Roy	?
P.K. Acharya, Dict. Hindu Arch.	?
Pali Dictt.	?
Pargiter	?
Pargiter ap. Hoernle MR	?
Pat.	Patañjali.
Patañjali	Patañjali.
Professor Paul Mus (oral communication, May, 1949)	?
Pañc. Rec.	Edgerton, Pañchatantra Reconstructed.
Pañcat. Koseg.	?
PB	?
PBr	?
Pe Maung Tin	?
Pe Maung Tin transl.	?
Pischel	SBBA 1904 pp. 807—827: Bruchstücke des Sanskrit-kanons der Buddhisten aus Idykutšari. A few rarer words cited by number of page and manuscript-folio.
Pischel SBBA 1904	?
Pischel, SBAW	?
Pischel, SBBA 1904	?
Pischel², HOS	?
Pischelʼs Transl.	?
Piṅg.	?
Prof. Lo Chʼang-pei	?
Prof. Mus	?
Prof. Rahder	?
Professor W.N. Brown	?
Przyluski, Açoka	?
Prāt	Prātimokṣasūtra des Sarvāstivādins, ed. Finot (with translation of Chinese version by Huber), JAs. XI.2 (1913), 473 ff.
PTS ed. (of Geiger)	?
PTSD	Pali Text Societyʼs Pali-English Dictionary.
Pug.	Puggala Paññatti (Pali).
Pugg.	Puggala Paññatti (Pali).
Pugg. comm.	?
Pugg.p.	Puggala Paññatti (Pali).
Puggala-paññatti	Puggala Paññatti (Pali).
Puggalap.	Puggala Paññatti (Pali).
Pv	Petavatthu (Pali).
Pv comm.	Petavatthu (Pali).
Pv.	Petavatthu (Pali).
Pv. comm.	Petavatthu (Pali).
pw	Boehtlingk, Sanskrit Wörterbuch in kürzerer Fassung.
Pāṇ.	Pāṇiniʼs Aṣṭādhyāyī
Pūrṇabhadraʼs Pañc., Hertel	?
R. Otto Franke, in Königsberger Beiträge, 1929	?
Ragh.	?
Rahder	?
Rahder, App. to Dbh	?
Rahder, Hobogirin	?
Rahder, JAOS	?
Rapson and Noble, Kharoṣṭhī Inscriptions (Stein collection), vol. 3	?
Ratnach.	Ratnachandra, Ardha-Māgadhī Dictionary (5 vols.).
Ratnachandra	?
Reeks, Deel	?
Renou	?
Renou, Etudes de gram. scte., 1936	?
Renou, Gr. scte.	?
Renou, in C. Kunhan Raja Presentation Volume	?
Renou, JA 1939	?
Renou, JA Jul.-Sept. 1939	?
Renou, JA Jul.—Sept. 1939	?
Renou, JA. 1939	?
Renou. JA 1939	?
Rh.D.	?
Rhys Davids	?
Rhys Davids, Dialogues 1 (1899)	?
Ridding	?
Rockhill	?
Rowell	?
RP	Rāṣṭrapālaparipṛcchā, ed. Finot, St. Petersburg, 1901.
RV	Rig Veda.
RV.	Rig Veda.
Régamey	Samādhirājasūtra, (1) chapters 8, 19, 22, ed. Régamey, Warsaw, 1938, cited by chapters and numbered sections or verses; (2) ed. Das and Vidyābhūshan (Calcutta, 1896); references (only a few; text incredibly corrupt) cited by page and lien, thus: ‘p. —, line —’.
Régamey, Samādh.	Samādhirājasūtra, (1) chapters 8, 19, 22, ed. Régamey, Warsaw, 1938, cited by chapters and numbered sections or verses; (2) ed. Das and Vidyābhūshan (Calcutta, 1896); references (only a few; text incredibly corrupt) cited by page and lien, thus: ‘p. —, line —’.
Régameyʼs note	Samādhirājasūtra, (1) chapters 8, 19, 22, ed. Régamey, Warsaw, 1938, cited by chapters and numbered sections or verses; (2) ed. Das and Vidyābhūshan (Calcutta, 1896); references (only a few; text incredibly corrupt) cited by page and lien, thus: ‘p. —, line —’.
Régameyʼs transl.	Samādhirājasūtra, (1) chapters 8, 19, 22, ed. Régamey, Warsaw, 1938, cited by chapters and numbered sections or verses; (2) ed. Das and Vidyābhūshan (Calcutta, 1896); references (only a few; text incredibly corrupt) cited by page and lien, thus: ‘p. —, line —’.
Rājat.	Rājataraṃgiṇī (ed. Stein).
Rājataraṅginī, ed. Stein	?
Rām.	Rāmāyaṇa (NWRām. = Northwestern Rām.)
Rām. comm.	Rāmāyaṇa (NWRām. = Northwestern Rām.)
Rām. Gorr.	Rāmāyaṇa, Gorresio edition
Rāmatīrtha on Sadānanda	?
Rʼs note	?
S. Lévi, JA. Nov.—Dec. 1912	?
S. Lévi, LaVallée-Poussin	?
S.K. De, NIA	?
Sakkapañhasutta	?
Samarāiccakahā	?
Samy Ag	?
Samy Āg	?
Samādh	Samādhirājasūtra, (1) chapters 8, 19, 22, ed. Régamey, Warsaw, 1938, cited by chapters and numbered sections or verses; (2) ed. Das and Vidyābhūshan (Calcutta, 1896); references (only a few; text incredibly corrupt) cited by page and lien, thus: ‘p. —, line —’.
Saptaśatakam, ed. Weber	?
Sarup	?
Saundaran.	?
Saṃy.	?
Saṃy. Āg.	Saṃyuktāgama; fragments from Stein mss. ed. LaVallée Poussin, JRAS 1913, 569 ff.; a few references to numbers of fragments (1—15), followed by r(ecto) or v(erso) when necessary, and line of mss.
SB	?
SBE	Sacred Books of the East.
SBE 13	?
SBE 49 part 2	?
SBE 49 pt. 2	?
SBE 49 Pt. 2	?
SBE 49, Part 2	?
SBE 49.2	?
Schayer, RO	?
Schmidt	R. Schmidt, Nachträge zum Sanskrit Wörterbuch…von Otto Boehtlingk.
Schmidt, Nachtr.	R. Schmidt, Nachträge zum Sanskrit Wörterbuch…von Otto Boehtlingk.
Schmidt, Nachträge	R. Schmidt, Nachträge zum Sanskrit Wörterbuch…von Otto Boehtlingk.
Schmidtʼs Nachträge	R. Schmidt, Nachträge zum Sanskrit Wörterbuch…von Otto Boehtlingk.
Schmīdt, Nachträge	R. Schmidt, Nachträge zum Sanskrit Wörterbuch…von Otto Boehtlingk.
Seidenstücker	?
Sen.	Mahāvastu, ed. Senart, Paris, 1882, 1890, 1897. The first volume of Jonesʼs translation (London, 1949) appeared, to my regret, too late to be much used (I received it in 1950).
Senart	Mahāvastu, ed. Senart, Paris, 1882, 1890, 1897. The first volume of Jonesʼs translation (London, 1949) appeared, to my regret, too late to be much used (I received it in 1950).
Senarts	Mahāvastu, ed. Senart, Paris, 1882, 1890, 1897. The first volume of Jonesʼs translation (London, 1949) appeared, to my regret, too late to be much used (I received it in 1950).
Senart Introd.	Mahāvastu, ed. Senart, Paris, 1882, 1890, 1897. The first volume of Jonesʼs translation (London, 1949) appeared, to my regret, too late to be much used (I received it in 1950).
Senart, Index	Mahāvastu, ed. Senart, Paris, 1882, 1890, 1897. The first volume of Jonesʼs translation (London, 1949) appeared, to my regret, too late to be much used (I received it in 1950).
Senart, Introd.	Mahāvastu, ed. Senart, Paris, 1882, 1890, 1897. The first volume of Jonesʼs translation (London, 1949) appeared, to my regret, too late to be much used (I received it in 1950).
Senart, Légende du Buddha	?
Senartʼs Index	Mahāvastu, ed. Senart, Paris, 1882, 1890, 1897. The first volume of Jonesʼs translation (London, 1949) appeared, to my regret, too late to be much used (I received it in 1950).
Senartʼs Introd. for Jāt.	?
Senartʼs Kacc.	?
Senartʼs note	Mahāvastu, ed. Senart, Paris, 1882, 1890, 1897. The first volume of Jonesʼs translation (London, 1949) appeared, to my regret, too late to be much used (I received it in 1950).
Senartʼs notes	Mahāvastu, ed. Senart, Paris, 1882, 1890, 1897. The first volume of Jonesʼs translation (London, 1949) appeared, to my regret, too late to be much used (I received it in 1950).
Senartʼs text	Mahāvastu, ed. Senart, Paris, 1882, 1890, 1897. The first volume of Jonesʼs translation (London, 1949) appeared, to my regret, too late to be much used (I received it in 1950).
Sham.¹	?
Shama Sastri 1st ed.	?
Sheth	H.D.T. Sheth, Paia-sadda-mahaṇṇavo (Pkt.-Hindi Dict.), Calcutta, 1923—1928.
Schiefner	?
Shāh.	?
Sieg and Siegling, Toch. Sprachreste	?
Sikṣ	?
Siri-j.	?
Smith	?
SN	SaMyuttanikāya (Pali).
Sn	Suttanipāta (Pali).
SN comm.	SaMyuttanikāya (Pali).
Sn comm.	Suttanipāta (Pali).
Sn. comm.	Suttanipāta (Pali).
SP	Saddharmapuṇḍarīka, ed. Kern and Nanjio, St. Petersburg, 1912, abbreviated KN; supplementary references to ed. of Wogihara and Tsuchida, Tokyo, 1934—35, abbreviated WT; fragments of ‘Kashgar’ or Central Asiatic recension, ed. Thomas and Lüders, ap. Hoernle, MR 133 ff., 144 ff.; others, ed. LaVallée Poussin, JRAS 1911, 1070 ff.; transl. Burnouf (Lotus de la Bonne Loi, Paris, 1852), and Kern (SBE 21, Oxford, 1884). Tibetan citations chiefly from block-print in my possession, partly from WT. When my work was practically ready for print, my colleague Professor Rahder received, and lent to me, the photostatic reproduction of the ms. referred to by WT as Ḱ. It has been cited a very few times. The quotations from it in WT seem to be very inaccurate.
Speyer	see Skt. Synt., and VSS; also, in the preceding list, s.vv. Av and Jm. Speyer, Sanskrit Syntax.
Speyer (Index)	Avadāna-śataka, ed. Speyer, 2 vols., St. Petersburg, 1902, 1906; transl. Feer, Annales du Musée Guimet 18 (1891).
Speyer Av	Avadāna-śataka, ed. Speyer, 2 vols., St. Petersburg, 1902, 1906; transl. Feer, Annales du Musée Guimet 18 (1891).
Speyer Av Introd.	Avadāna-śataka, ed. Speyer, 2 vols., St. Petersburg, 1902, 1906; transl. Feer, Annales du Musée Guimet 18 (1891).
Speyer on Av	Avadāna-śataka, ed. Speyer, 2 vols., St. Petersburg, 1902, 1906; transl. Feer, Annales du Musée Guimet 18 (1891).
Speyer Transl.	Avadāna-śataka, ed. Speyer, 2 vols., St. Petersburg, 1902, 1906; transl. Feer, Annales du Musée Guimet 18 (1891).
Speyer, Av	Avadāna-śataka, ed. Speyer, 2 vols., St. Petersburg, 1902, 1906; transl. Feer, Annales du Musée Guimet 18 (1891).
Speyer, Av Index	Avadāna-śataka, ed. Speyer, 2 vols., St. Petersburg, 1902, 1906; transl. Feer, Annales du Musée Guimet 18 (1891).
Speyer, Av Preface	Avadāna-śataka, ed. Speyer, 2 vols., St. Petersburg, 1902, 1906; transl. Feer, Annales du Musée Guimet 18 (1891).
Speyer, Corr.	Avadāna-śataka, ed. Speyer, 2 vols., St. Petersburg, 1902, 1906; transl. Feer, Annales du Musée Guimet 18 (1891).
Speyer, Index	Avadāna-śataka, ed. Speyer, 2 vols., St. Petersburg, 1902, 1906; transl. Feer, Annales du Musée Guimet 18 (1891).
Speyer, Index to Av	Avadāna-śataka, ed. Speyer, 2 vols., St. Petersburg, 1902, 1906; transl. Feer, Annales du Musée Guimet 18 (1891).
Speyer, note	Avadāna-śataka, ed. Speyer, 2 vols., St. Petersburg, 1902, 1906; transl. Feer, Annales du Musée Guimet 18 (1891).
Speyer, note on Av	Avadāna-śataka, ed. Speyer, 2 vols., St. Petersburg, 1902, 1906; transl. Feer, Annales du Musée Guimet 18 (1891).
Speyer, Preface to Av	Avadāna-śataka, ed. Speyer, 2 vols., St. Petersburg, 1902, 1906; transl. Feer, Annales du Musée Guimet 18 (1891).
Speyer, Skt. Synt.	Speyer, Sanskrit Syntax.
Speyer, Transl.	?
Speyer, transl. of Jm	Jātakamālā, ed. Kern (HOS 1), Boston, 1891. Its language is close to standard Skt., but contains quite a number of BHS words, and even a few forms; see § 1.53, fn. 17. Transl. Speyer, London, 1895.
Speyer, VSS	?
Speyerʼs Index	?
Speyerʼs Index to Av	Avadāna-śataka, ed. Speyer, 2 vols., St. Petersburg, 1902, 1906; transl. Feer, Annales du Musée Guimet 18 (1891).
Speyerʼs note	?
Speyerʼs transl.	?
St. Julien	?
Stael-Holstein, Intr.	?
Stael-Holstein, KP	?
Stcherbatskoy, Abhisamayālaṃkāra (Bibl. Bu. 23)	?
Stein	?
Stein <ab>ms.</ab> fragm.	?
Stein <ab>ms.</ab> fragment	?
Stein <ab>ms.</ab> fragments	?
Stein <ab>ms.</ab> fragments <ab>publ.</ab>	?
Stein fragment of BHS	?
Stenzler	?
Studies	?
Stönner, SBBA 1904	?
Sukh	Sukhāvatīvyūha (‘Larger’ and ‘Smaller’), ed. Müller, Oxford, 1883.
Sukthankar	?
Suparṇ.	?
Supatta Jāt.	?
Supatta-Jāt.	?
Suv	Suvarṇabhāsottamasūtra, ed. Nobel, Leipzig, 1937; Tibetan version, ed. same, Leiden and Stuttgart, 1944.
Suzuki	Laṅkāvatāra-sūtra, ed. Nanjio, Kyoto, 1923; transl. Suzuki, London, 1932; Index, by Suzuki, Kyoto, 1934; ‘Studies’ = Suzuki, Studies in the Lankavatara Sutra, London, 1930.
Susa	?
Suzuki Transl.	?
Suzuki transl.	?
Suzuki Transl. and Index	?
Suzuki, Gloss.	?
Suzuki, Index	?
Suzuki, Index, on Laṅk	Laṅkāvatāra-sūtra, ed. Nanjio, Kyoto, 1923; transl. Suzuki, London, 1932; Index, by Suzuki, Kyoto, 1934; ‘Studies’ = Suzuki, Studies in the Lankavatara Sutra, London, 1930.
Suzuki, Stud.	?
Suzuki, Studies	?
Suzuki, Studies in Laṅk.	Laṅkāvatāra-sūtra, ed. Nanjio, Kyoto, 1923; transl. Suzuki, London, 1932; Index, by Suzuki, Kyoto, 1934; ‘Studies’ = Suzuki, Studies in the Lankavatara Sutra, London, 1930.
Suzuki, Studies, Gloss.	?
Suzuki, Transl.	?
Suzuki, Transl. of Laṅk	Laṅkāvatāra-sūtra, ed. Nanjio, Kyoto, 1923; transl. Suzuki, London, 1932; Index, by Suzuki, Kyoto, 1934; ‘Studies’ = Suzuki, Studies in the Lankavatara Sutra, London, 1930.
Suzukiʼs Index	?
Suzukiʼs Index and Glossary	?
Suzukiʼs Index to Laṅk	Laṅkāvatāra-sūtra, ed. Nanjio, Kyoto, 1923; transl. Suzuki, London, 1932; Index, by Suzuki, Kyoto, 1934; ‘Studies’ = Suzuki, Studies in the Lankavatara Sutra, London, 1930.
Suzukiʼs transl.	?
Suzukiʼs transl., and Studies	?
Suśr.	?
Svay	(Vṛhat-)Svayambhū Purāṇa, ed. Haraprasad Sastri, Calcutta, 1894—1900; of very little use and only rarely cited. Cf. Winternitz, Hist. Ind. Lit. II, 376, note.
Sādh	Sādhanamālā, ed. Bhattacharya, Baroda, 2 vols., 1925, 1928.
Sāl	?
Sāma Jāt.	?
Sāmav. Br.	?
Sūci-j.	?
Sūtrāl.	Asaṅga, Mahāyāna-sūtrālaṃkāra, ed. and transl. Lévi, Bibliothèque de lʼÉcole des Hautes Études, 159 and 190, Paris, 1907, 1911. The language is standard Skt., but the text and Léviʼs notes are important for the understanding of many technical terms. Cited by chapter and verse (with commentary after each verse).
Sūtrāl. comm.	?
Sūtrālaṃkāra	?
Taisho <lang>Chin.</lang> canon text 1300	?
Takakusu, JPTS 1904—5	Takakusu in Journal of the Pali Text Society.
TB.	Taittirīya Brāhmaṇa.
Tedesco, JAOS	?
Teresina Rowell, ‘The background and early use of the Buddhakṣetra concept,’ The Eastern Buddhist	?
Therag.	Theragāthā (Pali).
Therīg.	Therīgāthā (Pali).
Thomas	?
Thomas ap. Hoernle MR	Saddharmapuṇḍarīka, ed. Kern and Nanjio, St. Petersburg, 1912, abbreviated KN; supplementary references to ed. of Wogihara and Tsuchida, Tokyo, 1934—35, abbreviated WT; fragments of ‘Kashgar’ or Central Asiatic recension, ed. Thomas and Lüders, ap. Hoernle, MR 133 ff., 144 ff.; others, ed. LaVallée Poussin, JRAS 1911, 1070 ff.; transl. Burnouf (Lotus de la Bonne Loi, Paris, 1852), and Kern (SBE 21, Oxford, 1884). Tibetan citations chiefly from block-print in my possession, partly from WT. When my work was practically ready for print, my colleague Professor Rahder received, and lent to me, the photostatic reproduction of the ms. referred to by WT as Ḱ. It has been cited a very few times. The quotations from it in WT seem to be very inaccurate.
Thomas ap. Hoernle, MR	Saddharmapuṇḍarīka, ed. Kern and Nanjio, St. Petersburg, 1912, abbreviated KN; supplementary references to ed. of Wogihara and Tsuchida, Tokyo, 1934—35, abbreviated WT; fragments of ‘Kashgar’ or Central Asiatic recension, ed. Thomas and Lüders, ap. Hoernle, MR 133 ff., 144 ff.; others, ed. LaVallée Poussin, JRAS 1911, 1070 ff.; transl. Burnouf (Lotus de la Bonne Loi, Paris, 1852), and Kern (SBE 21, Oxford, 1884). Tibetan citations chiefly from block-print in my possession, partly from WT. When my work was practically ready for print, my colleague Professor Rahder received, and lent to me, the photostatic reproduction of the ms. referred to by WT as Ḱ. It has been cited a very few times. The quotations from it in WT seem to be very inaccurate.
Thomas JRAS	Thomas in Journal of the Royal Asiatic Society.
Thomas, ap. Hoernle MR	Saddharmapuṇḍarīka, ed. Kern and Nanjio, St. Petersburg, 1912, abbreviated KN; supplementary references to ed. of Wogihara and Tsuchida, Tokyo, 1934—35, abbreviated WT; fragments of ‘Kashgar’ or Central Asiatic recension, ed. Thomas and Lüders, ap. Hoernle, MR 133 ff., 144 ff.; others, ed. LaVallée Poussin, JRAS 1911, 1070 ff.; transl. Burnouf (Lotus de la Bonne Loi, Paris, 1852), and Kern (SBE 21, Oxford, 1884). Tibetan citations chiefly from block-print in my possession, partly from WT. When my work was practically ready for print, my colleague Professor Rahder received, and lent to me, the photostatic reproduction of the ms. referred to by WT as Ḱ. It has been cited a very few times. The quotations from it in WT seem to be very inaccurate.
Thomas, JRAS	Thomas in Journal of the Royal Asiatic Society.
Ting	?
Tingʼs Dict.	?
Toch. Gram.	?
Transl.	?
transl. Bendall and Rouse	Śikṣāsamuccaya, ed. Bendall, St. Petersburg, 1897—1902; transl. Bendall and Rouse, London, 1922.
transl. of Bendall and Rouse	Śikṣāsamuccaya, ed. Bendall, St. Petersburg, 1897—1902; transl. Bendall and Rouse, London, 1922.
Transl. of Bendall and Rouse	Śikṣāsamuccaya, ed. Bendall, St. Petersburg, 1897—1902; transl. Bendall and Rouse, London, 1922.
transl. of Kalpa Sūtra	?
Trenckner	?
Trik.	Trikāṇḍaśeṣa (a Skt. lexicographer cited in BR; contains many BHS words).
Trikāṇḍaśeṣa	a Skt. lexicographer cited in BR; contains many BHS words.
TS	Taittirīya Saṃhitā.
Turner, Nep. Dict.	Dictionary of the Nepali Language, London, 1931.
Turner, Nepali Dict.	Dictionary of the Nepali Language, London, 1931.
Turnour	?
Turnourʼs Mahāv.	?
Tārā	?
Tāranātha	?
Ud	Udānavarga; chap. 1—21, ed. Chakravarti (1930; except ch. 4, for which see Lévi, JAs. X. 20, 1912, 203 ff.); ch. 29, ed. Pischel, SBBA 1908, 968 ff.; ch. 30, 31, 32, ed. LaVallée Poussin, JRAS 1912, 369 ff. Cited by chapter and verse.
Ud.	?
Uhlenbeck	?
Upāli-Gaṅgapāla-Jāt.	?
Uttarādh.	?
Vaj	Vajracchedikā, ed. Müller, Oxford, 1881; fragments of Central Asiatic version, ed. Pargiter, ap. Hoernle MR 179 ff.
Vaj.	?
Valāhassa Jāt.	?
Valāhassa-J.	?
Var.Bṛh.S.	?
VarBṛS.	?
Varāh.Bṛh.S.	Varāhamihira, Bṛhat-saṃhitā.
Vikr. car. JR	JR (Vikramacarita)
Vikramac. MR	?
Vikramacarita JR	JR (Vikramacarita)
Vin.	Vinayapiṭaka (Pali).
Vin. comm.	?
Vism	Visuddhi-magga (Pali).
Vism.	Visuddhi-magga (Pali).
Viṣṇusm.	?
Vjutp.	?
Vogel, Versl. en Med. d. K. Akad. v. Wet. Amsterdam, Afd. Letterk.	?
VS	?
VS.	?
VSS	Speyer, Vedische und Sanskrit-Syntax.
Vv.	Vimānavatthu (Pali).
Vv. comm.	Vimānavatthu (Pali).
Vār.Bṛ.S.	?
Wackernagel	?
Wackernagel-Debrunner	?
Walde-Pokorny	?
Waldschmidt	?
Waldschmidt, Kl. Skt. Texte	?
Waldschmidt, Kl. Skt. Texte 3	?
Waldschmidt, Kl. Skt. Texte 4	?
Waldschmidt, Kl. Skt. Texte 4, Mahāsamāj.	?
Waldschmidt, NGGW, ph.-h. Kl., Fachgr. III, NF II Nr. 3 (1939)	?
Waldschmidtʼs note	?
Ware, JAOS	?
Warren, B. in Tr.	?
Wassiljew	?
Wassiliew	?
Watanabe	?
Weber	?
Weber I.St.	?
Weber ISt.	?
Weber ZDMG	Weber in Zeitschrift der deutschen morgenländischen Gesellschaft.
Weber, Die vedischen Nachrichten von den naxatra	?
Weller	see LV. Lalitavistara, ed. Lefmann, Halle, 1902
Weller, Prosa des LV	?
Wellerʼs note	?
Wh. Roots	Roots of the Sanskrit Language by William Dwight Whitney, 1885.
Whitney	?
Whitney, Gr.	Sanskrit Grammar by William Dwight Whitney, 1879.
Whitney, Roots	Roots of the Sanskrit Language by William Dwight Whitney, 1885.
Whitney-Lanman	?
Wilson	H. H. Wilsonʼs Sanskrit Dictionary, as cited in MW.
Wilson, ap. MW	?
Wilsonʼs Dict.	?
Windisch, Māra und Buddha	?
Winternitz, H.I.Lit.	?
Winternitz, Hist. Ind. Lit.	?
Winternitz, Hist. Ind. Lit., 2 (1933)	?
Winternitz, ZDMG	Winternitz in Zeitschrift der deutschen morgenländischen Gesellschaft.
Wogihara	?
Wogihara ap. Bendall	?
Wogihara in Bbh. Lex. 32	see Bbh. Bodhisattvabhūmi, ed. Wogihara, Tokyo, 1930—36. Includes the editorʼs dissertation, Lexikalisches aus der Bodhisattvabhūmi, which is referred to as Wogihara, Lex.
Wogihara, Bbh. Lex.	see Bbh. Bodhisattvabhūmi, ed. Wogihara, Tokyo, 1930—36. Includes the editorʼs dissertation, Lexikalisches aus der Bodhisattvabhūmi, which is referred to as Wogihara, Lex.
Wogihara, Index	?
Wogihara, Lex.	see Bbh. Bodhisattvabhūmi, ed. Wogihara, Tokyo, 1930—36. Includes the editorʼs dissertation, Lexikalisches aus der Bodhisattvabhūmi, which is referred to as Wogihara, Lex.
Wogihara, Preface to Bbh	?
Wogihara, ZDMG	Wogihara in Zeitschrift der deutschen morgenländischen Gesellschaft.
Wogiharaʼs Index	?
Wogiharaʼs Index to Bbh	?
Wogiharaʼs note	?
Wogihāra, ZDMG	Wogihāra in Zeitschrift der deutschen morgenländischen Gesellschaft.
WT	see SP. Saddharmapuṇḍarīka, ed. Kern and Nanjio, St. Petersburg, 1912, abbreviated KN; supplementary references to ed. of Wogihara and Tsuchida, Tokyo, 1934—35, abbreviated WT; fragments of ‘Kashgar’ or Central Asiatic recension, ed. Thomas and Lüders, ap. Hoernle, MR 133 ff., 144 ff.; others, ed. LaVallée Poussin, JRAS 1911, 1070 ff.; transl. Burnouf (Lotus de la Bonne Loi, Paris, 1852), and Kern (SBE 21, Oxford, 1884). Tibetan citations chiefly from block-print in my possession, partly from WT. When my work was practically ready for print, my colleague Professor Rahder received, and lent to me, the photostatic reproduction of the ms. referred to by WT as Ḱ. It has been cited a very few times. The quotations from it in WT seem to be very inaccurate.
Woolnerʼs Introduction to Prakrit, Vocabulary	?
Yogayātrā	?
Yogācāras	?
Yājñ.	Yājñavalkya (Dharmaśāstra).
Zachariae	?
Zam. ap. Das	?
Ācār. (Schubring)	?
ĀpŚ.	?
Śak.	?
Shama Sastri, Kauṭ. Arth., Shama S.¹	?
Śaṃkara	?
Śakrapraśnasūtra, Waldschmidt, Kl. Skt. Texte 4	?
Śaur.	?
ŚB	Śatapatha Brāhmaṇa (Mādhy. — Mādhyaṃdina, K. = Kāṇva recension).
ŚB K.	Śatapatha Brāhmaṇa (Mādhy. — Mādhyaṃdina, K. = Kāṇva recension).
ŚB Mādhy.	Śatapatha Brāhmaṇa (Mādhy. — Mādhyaṃdina, K. = Kāṇva recension).
ŚB.	Śatapatha Brāhmaṇa (Mādhy. — Mādhyaṃdina, K. = Kāṇva recension).
Śiks	Śikṣāsamuccaya, ed. Bendall, St. Petersburg, 1897—1902; transl. Bendall and Rouse, London, 1922.
ŚGS	Śāṅkhāyana Gṛhya Sūtra.
Śikṣ	Śikṣāsamuccaya, ed. Bendall, St. Petersburg, 1897—1902; transl. Bendall and Rouse, London, 1922.
Śikṣ.	Śikṣāsamuccaya, ed. Bendall, St. Petersburg, 1897—1902; transl. Bendall and Rouse, London, 1922.
ŚKD	śabda—kalpa-druma
ŚsP	Śatasāhasrikā-prajñāpāramitā, ed. P. Ghoṣa, Bibliotheca Indica, Calcutta, 1902 ff.
ŚsP²	Śatasāhasrikā-prajñāpāramitā, ed. P. Ghoṣa, Bibliotheca Indica, Calcutta, 1902 ff.
ŚsP³	Śatasāhasrikā-prajñāpāramitā, ed. P. Ghoṣa, Bibliotheca Indica, Calcutta, 1902 ff.
ŚsP¹	Śatasāhasrikā-prajñāpāramitā, ed. P. Ghoṣa, Bibliotheca Indica, Calcutta, 1902 ff.
Śuka-paṇḍita	?
Śukasaptati text. orn.	?
Śāl	Śālistambasūtra, (reconstructed) ed. LaVallée Poussin; Bouddhisme, Études et matériaux, Théorie des douze causes (Gand, 1913), pp. 69—90.
ŚŚS	?
Ṣaḍv. Br.	?
